Date,Region,Daily confirmed,Daily probable,Daily deceased,Daily total cases,Cumulative confirmed,Cumulative probable,Cumulative deceased,Cumulative total cases
09/11/2020,Auckland,2,0,0,2,278,51,1,329
09/11/2020,Bay of Plenty,0,0,0,0,34,14,0,48
09/11/2020,Canterbury,0,0,0,0,172,65,12,237
09/11/2020,Capital and Coast,0,0,0,0,74,24,2,98
09/11/2020,Counties Manukau,1,0,0,1,292,24,1,316
09/11/2020,Hawke's Bay,0,0,0,0,38,6,0,44
09/11/2020,Hutt Valley,0,0,0,0,20,3,0,23
09/11/2020,Lakes,0,0,0,0,15,1,0,16
09/11/2020,Midcentral,0,0,0,0,27,5,0,32
09/11/2020,Nelson Marlborough,0,0,0,0,38,12,0,50
09/11/2020,Northland,0,0,0,0,26,2,0,28
09/11/2020,South Canterbury,0,0,0,0,15,2,0,17
09/11/2020,Southern,0,0,0,0,186,30,2,216
09/11/2020,Tairawhiti,0,0,0,0,3,1,0,4
09/11/2020,Taranaki,0,0,0,0,14,2,0,16
09/11/2020,Waikato,0,0,0,0,155,39,2,194
09/11/2020,Wairarapa,0,0,0,0,6,2,0,8
09/11/2020,Waitemata,0,0,0,0,225,71,4,296
09/11/2020,West Coast,0,0,0,0,4,1,1,5
09/11/2020,Whanganui,0,0,0,0,8,1,0,9
08/11/2020,Auckland,1,0,0,1,276,51,1,327
08/11/2020,Bay of Plenty,0,0,0,0,34,14,0,48
08/11/2020,Canterbury,0,0,0,0,172,65,12,237
08/11/2020,Capital and Coast,0,0,0,0,74,24,2,98
08/11/2020,Counties Manukau,0,0,0,0,291,24,1,315
08/11/2020,Hawke's Bay,0,0,0,0,38,6,0,44
08/11/2020,Hutt Valley,0,0,0,0,20,3,0,23
08/11/2020,Lakes,0,0,0,0,15,1,0,16
08/11/2020,Midcentral,0,0,0,0,27,5,0,32
08/11/2020,Nelson Marlborough,0,0,0,0,38,12,0,50
08/11/2020,Northland,0,0,0,0,26,2,0,28
08/11/2020,South Canterbury,0,0,0,0,15,2,0,17
08/11/2020,Southern,0,0,0,0,186,30,2,216
08/11/2020,Tairawhiti,0,0,0,0,3,1,0,4
08/11/2020,Taranaki,0,0,0,0,14,2,0,16
08/11/2020,Waikato,0,0,0,0,155,39,2,194
08/11/2020,Wairarapa,0,0,0,0,6,2,0,8
08/11/2020,Waitemata,0,0,0,0,225,71,4,296
08/11/2020,West Coast,0,0,0,0,4,1,1,5
08/11/2020,Whanganui,0,0,0,0,8,1,0,9
07/11/2020,Auckland,4,0,0,4,275,51,1,326
07/11/2020,Bay of Plenty,0,0,0,0,34,14,0,48
07/11/2020,Canterbury,0,0,0,0,172,65,12,237
07/11/2020,Capital and Coast,0,0,0,0,74,24,2,98
07/11/2020,Counties Manukau,1,0,0,1,291,24,1,315
07/11/2020,Hawke's Bay,0,0,0,0,38,6,0,44
07/11/2020,Hutt Valley,1,0,0,1,20,3,0,23
07/11/2020,Lakes,0,0,0,0,15,1,0,16
07/11/2020,Midcentral,0,0,0,0,27,5,0,32
07/11/2020,Nelson Marlborough,0,0,0,0,38,12,0,50
07/11/2020,Northland,0,0,0,0,26,2,0,28
07/11/2020,South Canterbury,0,0,0,0,15,2,0,17
07/11/2020,Southern,0,0,0,0,186,30,2,216
07/11/2020,Tairawhiti,0,0,0,0,3,1,0,4
07/11/2020,Taranaki,0,0,0,0,14,2,0,16
07/11/2020,Waikato,0,0,0,0,155,39,2,194
07/11/2020,Wairarapa,0,0,0,0,6,2,0,8
07/11/2020,Waitemata,0,0,0,0,225,71,4,296
07/11/2020,West Coast,0,0,0,0,4,1,1,5
07/11/2020,Whanganui,0,0,0,0,8,1,0,9
06/11/2020,Auckland,1,0,0,1,271,51,1,322
06/11/2020,Bay of Plenty,0,0,0,0,34,14,0,48
06/11/2020,Canterbury,0,0,0,0,172,65,12,237
06/11/2020,Capital and Coast,0,0,0,0,74,24,2,98
06/11/2020,Counties Manukau,0,0,0,0,290,24,1,314
06/11/2020,Hawke's Bay,0,0,0,0,38,6,0,44
06/11/2020,Hutt Valley,0,0,0,0,19,3,0,22
06/11/2020,Lakes,0,0,0,0,15,1,0,16
06/11/2020,Midcentral,0,0,0,0,27,5,0,32
06/11/2020,Nelson Marlborough,0,0,0,0,38,12,0,50
06/11/2020,Northland,0,0,0,0,26,2,0,28
06/11/2020,South Canterbury,0,0,0,0,15,2,0,17
06/11/2020,Southern,0,0,0,0,186,30,2,216
06/11/2020,Tairawhiti,0,0,0,0,3,1,0,4
06/11/2020,Taranaki,0,0,0,0,14,2,0,16
06/11/2020,Waikato,0,0,0,0,155,39,2,194
06/11/2020,Wairarapa,0,0,0,0,6,2,0,8
06/11/2020,Waitemata,0,0,0,0,225,71,4,296
06/11/2020,West Coast,0,0,0,0,4,1,1,5
06/11/2020,Whanganui,0,0,0,0,8,1,0,9
05/11/2020,Auckland,1,0,0,1,270,51,1,321
05/11/2020,Bay of Plenty,0,0,0,0,34,14,0,48
05/11/2020,Canterbury,0,0,0,0,172,65,12,237
05/11/2020,Capital and Coast,0,0,0,0,74,24,2,98
05/11/2020,Counties Manukau,0,0,0,0,290,24,1,314
05/11/2020,Hawke's Bay,0,0,0,0,38,6,0,44
05/11/2020,Hutt Valley,0,0,0,0,19,3,0,22
05/11/2020,Lakes,0,0,0,0,15,1,0,16
05/11/2020,Midcentral,0,0,0,0,27,5,0,32
05/11/2020,Nelson Marlborough,0,0,0,0,38,12,0,50
05/11/2020,Northland,0,0,0,0,26,2,0,28
05/11/2020,South Canterbury,0,0,0,0,15,2,0,17
05/11/2020,Southern,0,0,0,0,186,30,2,216
05/11/2020,Tairawhiti,0,0,0,0,3,1,0,4
05/11/2020,Taranaki,0,0,0,0,14,2,0,16
05/11/2020,Waikato,0,0,0,0,155,39,2,194
05/11/2020,Wairarapa,0,0,0,0,6,2,0,8
05/11/2020,Waitemata,0,0,0,0,225,71,4,296
05/11/2020,West Coast,0,0,0,0,4,1,1,5
05/11/2020,Whanganui,0,0,0,0,8,1,0,9
04/11/2020,Auckland,2,0,0,2,269,51,1,320
04/11/2020,Bay of Plenty,0,0,0,0,34,14,0,48
04/11/2020,Canterbury,0,0,0,0,172,65,12,237
04/11/2020,Capital and Coast,0,0,0,0,74,24,2,98
04/11/2020,Counties Manukau,1,0,0,1,290,24,1,314
04/11/2020,Hawke's Bay,0,0,0,0,38,6,0,44
04/11/2020,Hutt Valley,0,0,0,0,19,3,0,22
04/11/2020,Lakes,0,0,0,0,15,1,0,16
04/11/2020,Midcentral,0,0,0,0,27,5,0,32
04/11/2020,Nelson Marlborough,0,0,0,0,38,12,0,50
04/11/2020,Northland,0,0,0,0,26,2,0,28
04/11/2020,South Canterbury,0,0,0,0,15,2,0,17
04/11/2020,Southern,0,0,0,0,186,30,2,216
04/11/2020,Tairawhiti,0,0,0,0,3,1,0,4
04/11/2020,Taranaki,0,0,0,0,14,2,0,16
04/11/2020,Waikato,0,0,0,0,155,39,2,194
04/11/2020,Wairarapa,0,0,0,0,6,2,0,8
04/11/2020,Waitemata,0,0,0,0,225,71,4,296
04/11/2020,West Coast,0,0,0,0,4,1,1,5
04/11/2020,Whanganui,0,0,0,0,8,1,0,9
03/11/2020,Auckland,0,0,0,0,267,51,1,318
03/11/2020,Bay of Plenty,0,0,0,0,34,14,0,48
03/11/2020,Canterbury,1,0,0,1,172,65,12,237
03/11/2020,Capital and Coast,0,0,0,0,74,24,2,98
03/11/2020,Counties Manukau,0,0,0,0,289,24,1,313
03/11/2020,Hawke's Bay,0,0,0,0,38,6,0,44
03/11/2020,Hutt Valley,0,0,0,0,19,3,0,22
03/11/2020,Lakes,0,0,0,0,15,1,0,16
03/11/2020,Midcentral,0,0,0,0,27,5,0,32
03/11/2020,Nelson Marlborough,0,0,0,0,38,12,0,50
03/11/2020,Northland,0,0,0,0,26,2,0,28
03/11/2020,South Canterbury,0,0,0,0,15,2,0,17
03/11/2020,Southern,0,0,0,0,186,30,2,216
03/11/2020,Tairawhiti,0,0,0,0,3,1,0,4
03/11/2020,Taranaki,0,0,0,0,14,2,0,16
03/11/2020,Waikato,0,0,0,0,155,39,2,194
03/11/2020,Wairarapa,0,0,0,0,6,2,0,8
03/11/2020,Waitemata,0,0,0,0,225,71,4,296
03/11/2020,West Coast,0,0,0,0,4,1,1,5
03/11/2020,Whanganui,0,0,0,0,8,1,0,9
02/11/2020,Auckland,0,0,0,0,267,51,1,318
02/11/2020,Bay of Plenty,0,0,0,0,34,14,0,48
02/11/2020,Canterbury,1,0,0,1,171,65,12,236
02/11/2020,Capital and Coast,0,0,0,0,74,24,2,98
02/11/2020,Counties Manukau,4,0,0,4,289,24,1,313
02/11/2020,Hawke's Bay,0,0,0,0,38,6,0,44
02/11/2020,Hutt Valley,0,0,0,0,19,3,0,22
02/11/2020,Lakes,0,0,0,0,15,1,0,16
02/11/2020,Midcentral,0,0,0,0,27,5,0,32
02/11/2020,Nelson Marlborough,0,0,0,0,38,12,0,50
02/11/2020,Northland,0,0,0,0,26,2,0,28
02/11/2020,South Canterbury,0,0,0,0,15,2,0,17
02/11/2020,Southern,0,0,0,0,186,30,2,216
02/11/2020,Tairawhiti,0,0,0,0,3,1,0,4
02/11/2020,Taranaki,0,0,0,0,14,2,0,16
02/11/2020,Waikato,0,0,0,0,155,39,2,194
02/11/2020,Wairarapa,0,0,0,0,6,2,0,8
02/11/2020,Waitemata,0,0,0,0,225,71,4,296
02/11/2020,West Coast,0,0,0,0,4,1,1,5
02/11/2020,Whanganui,0,0,0,0,8,1,0,9
01/11/2020,Auckland,1,0,0,1,267,51,1,318
01/11/2020,Bay of Plenty,0,0,0,0,34,14,0,48
01/11/2020,Canterbury,1,0,0,1,170,65,12,235
01/11/2020,Capital and Coast,0,0,0,0,74,24,2,98
01/11/2020,Counties Manukau,1,0,0,1,285,24,1,309
01/11/2020,Hawke's Bay,0,0,0,0,38,6,0,44
01/11/2020,Hutt Valley,0,0,0,0,19,3,0,22
01/11/2020,Lakes,0,0,0,0,15,1,0,16
01/11/2020,Midcentral,0,0,0,0,27,5,0,32
01/11/2020,Nelson Marlborough,0,0,0,0,38,12,0,50
01/11/2020,Northland,0,0,0,0,26,2,0,28
01/11/2020,South Canterbury,0,0,0,0,15,2,0,17
01/11/2020,Southern,0,0,0,0,186,30,2,216
01/11/2020,Tairawhiti,0,0,0,0,3,1,0,4
01/11/2020,Taranaki,0,0,0,0,14,2,0,16
01/11/2020,Waikato,0,0,0,0,155,39,2,194
01/11/2020,Wairarapa,0,0,0,0,6,2,0,8
01/11/2020,Waitemata,0,0,0,0,225,71,4,296
01/11/2020,West Coast,0,0,0,0,4,1,1,5
01/11/2020,Whanganui,0,0,0,0,8,1,0,9
31/10/2020,Auckland,2,0,0,2,266,51,1,317
31/10/2020,Bay of Plenty,0,0,0,0,34,14,0,48
31/10/2020,Canterbury,0,0,0,0,169,65,12,234
31/10/2020,Capital and Coast,0,0,0,0,74,24,2,98
31/10/2020,Counties Manukau,2,0,0,2,284,24,1,308
31/10/2020,Hawke's Bay,0,0,0,0,38,6,0,44
31/10/2020,Hutt Valley,0,0,0,0,19,3,0,22
31/10/2020,Lakes,0,0,0,0,15,1,0,16
31/10/2020,Midcentral,0,0,0,0,27,5,0,32
31/10/2020,Nelson Marlborough,1,0,0,1,38,12,0,50
31/10/2020,Northland,0,0,0,0,26,2,0,28
31/10/2020,South Canterbury,0,0,0,0,15,2,0,17
31/10/2020,Southern,0,0,0,0,186,30,2,216
31/10/2020,Tairawhiti,0,0,0,0,3,1,0,4
31/10/2020,Taranaki,0,0,0,0,14,2,0,16
31/10/2020,Waikato,0,0,0,0,155,39,2,194
31/10/2020,Wairarapa,0,0,0,0,6,2,0,8
31/10/2020,Waitemata,0,0,0,0,225,71,4,296
31/10/2020,West Coast,0,0,0,0,4,1,1,5
31/10/2020,Whanganui,0,0,0,0,8,1,0,9
30/10/2020,Auckland,1,0,0,1,264,51,1,315
30/10/2020,Bay of Plenty,0,0,0,0,34,14,0,48
30/10/2020,Canterbury,0,0,0,0,169,65,12,234
30/10/2020,Capital and Coast,0,0,0,0,74,24,2,98
30/10/2020,Counties Manukau,5,0,0,5,282,24,1,306
30/10/2020,Hawke's Bay,0,0,0,0,38,6,0,44
30/10/2020,Hutt Valley,0,0,0,0,19,3,0,22
30/10/2020,Lakes,0,0,0,0,15,1,0,16
30/10/2020,Midcentral,0,0,0,0,27,5,0,32
30/10/2020,Nelson Marlborough,0,0,0,0,37,12,0,49
30/10/2020,Northland,0,0,0,0,26,2,0,28
30/10/2020,South Canterbury,0,0,0,0,15,2,0,17
30/10/2020,Southern,0,0,0,0,186,30,2,216
30/10/2020,Tairawhiti,0,0,0,0,3,1,0,4
30/10/2020,Taranaki,0,0,0,0,14,2,0,16
30/10/2020,Waikato,0,0,0,0,155,39,2,194
30/10/2020,Wairarapa,0,0,0,0,6,2,0,8
30/10/2020,Waitemata,0,0,0,0,225,71,4,296
30/10/2020,West Coast,0,0,0,0,4,1,1,5
30/10/2020,Whanganui,0,0,0,0,8,1,0,9
29/10/2020,Auckland,0,0,0,0,263,51,1,314
29/10/2020,Bay of Plenty,0,0,0,0,34,14,0,48
29/10/2020,Canterbury,1,0,0,1,169,65,12,234
29/10/2020,Capital and Coast,0,0,0,0,74,24,2,98
29/10/2020,Counties Manukau,0,0,0,0,277,24,1,301
29/10/2020,Hawke's Bay,0,0,0,0,38,6,0,44
29/10/2020,Hutt Valley,0,0,0,0,19,3,0,22
29/10/2020,Lakes,0,0,0,0,15,1,0,16
29/10/2020,Midcentral,0,0,0,0,27,5,0,32
29/10/2020,Nelson Marlborough,0,0,0,0,37,12,0,49
29/10/2020,Northland,0,0,0,0,26,2,0,28
29/10/2020,South Canterbury,0,0,0,0,15,2,0,17
29/10/2020,Southern,0,0,0,0,186,30,2,216
29/10/2020,Tairawhiti,0,0,0,0,3,1,0,4
29/10/2020,Taranaki,0,0,0,0,14,2,0,16
29/10/2020,Waikato,0,0,0,0,155,39,2,194
29/10/2020,Wairarapa,0,0,0,0,6,2,0,8
29/10/2020,Waitemata,0,0,0,0,225,71,4,296
29/10/2020,West Coast,0,0,0,0,4,1,1,5
29/10/2020,Whanganui,0,0,0,0,8,1,0,9
28/10/2020,Auckland,5,0,0,5,263,51,1,314
28/10/2020,Bay of Plenty,0,0,0,0,34,14,0,48
28/10/2020,Canterbury,0,0,0,0,168,65,12,233
28/10/2020,Capital and Coast,0,0,0,0,74,24,2,98
28/10/2020,Counties Manukau,1,0,0,1,277,24,1,301
28/10/2020,Hawke's Bay,0,0,0,0,38,6,0,44
28/10/2020,Hutt Valley,0,0,0,0,19,3,0,22
28/10/2020,Lakes,0,0,0,0,15,1,0,16
28/10/2020,Midcentral,0,0,0,0,27,5,0,32
28/10/2020,Nelson Marlborough,0,0,0,0,37,12,0,49
28/10/2020,Northland,0,0,0,0,26,2,0,28
28/10/2020,South Canterbury,0,0,0,0,15,2,0,17
28/10/2020,Southern,0,0,0,0,186,30,2,216
28/10/2020,Tairawhiti,0,0,0,0,3,1,0,4
28/10/2020,Taranaki,0,0,0,0,14,2,0,16
28/10/2020,Waikato,0,0,0,0,155,39,2,194
28/10/2020,Wairarapa,0,0,0,0,6,2,0,8
28/10/2020,Waitemata,0,0,0,0,225,71,4,296
28/10/2020,West Coast,0,0,0,0,4,1,1,5
28/10/2020,Whanganui,0,0,0,0,8,1,0,9
27/10/2020,Auckland,2,0,0,2,258,51,1,309
27/10/2020,Bay of Plenty,0,0,0,0,34,14,0,48
27/10/2020,Canterbury,0,0,0,0,168,65,12,233
27/10/2020,Capital and Coast,0,0,0,0,74,24,2,98
27/10/2020,Counties Manukau,1,0,0,1,276,24,1,300
27/10/2020,Hawke's Bay,0,0,0,0,38,6,0,44
27/10/2020,Hutt Valley,0,0,0,0,19,3,0,22
27/10/2020,Lakes,0,0,0,0,15,1,0,16
27/10/2020,Midcentral,0,0,0,0,27,5,0,32
27/10/2020,Nelson Marlborough,0,0,0,0,37,12,0,49
27/10/2020,Northland,0,0,0,0,26,2,0,28
27/10/2020,South Canterbury,0,0,0,0,15,2,0,17
27/10/2020,Southern,0,0,0,0,186,30,2,216
27/10/2020,Tairawhiti,0,0,0,0,3,1,0,4
27/10/2020,Taranaki,0,0,0,0,14,2,0,16
27/10/2020,Waikato,0,0,0,0,155,39,2,194
27/10/2020,Wairarapa,0,0,0,0,6,2,0,8
27/10/2020,Waitemata,0,0,0,0,225,71,4,296
27/10/2020,West Coast,0,0,0,0,4,1,1,5
27/10/2020,Whanganui,0,0,0,0,8,1,0,9
26/10/2020,Auckland,0,0,0,0,256,51,1,307
26/10/2020,Bay of Plenty,0,0,0,0,34,14,0,48
26/10/2020,Canterbury,0,0,0,0,168,65,12,233
26/10/2020,Capital and Coast,0,0,0,0,74,24,2,98
26/10/2020,Counties Manukau,1,0,0,1,275,24,1,299
26/10/2020,Hawke's Bay,0,0,0,0,38,6,0,44
26/10/2020,Hutt Valley,0,0,0,0,19,3,0,22
26/10/2020,Lakes,0,0,0,0,15,1,0,16
26/10/2020,Midcentral,0,0,0,0,27,5,0,32
26/10/2020,Nelson Marlborough,0,0,0,0,37,12,0,49
26/10/2020,Northland,0,0,0,0,26,2,0,28
26/10/2020,South Canterbury,0,0,0,0,15,2,0,17
26/10/2020,Southern,0,0,0,0,186,30,2,216
26/10/2020,Tairawhiti,0,0,0,0,3,1,0,4
26/10/2020,Taranaki,0,0,0,0,14,2,0,16
26/10/2020,Waikato,0,0,0,0,155,39,2,194
26/10/2020,Wairarapa,0,0,0,0,6,2,0,8
26/10/2020,Waitemata,0,0,0,0,225,71,4,296
26/10/2020,West Coast,0,0,0,0,4,1,1,5
26/10/2020,Whanganui,0,0,0,0,8,1,0,9
25/10/2020,Auckland,1,0,0,1,256,51,1,307
25/10/2020,Bay of Plenty,0,0,0,0,34,14,0,48
25/10/2020,Canterbury,3,0,0,3,168,65,12,233
25/10/2020,Capital and Coast,0,0,0,0,74,24,2,98
25/10/2020,Counties Manukau,0,0,0,0,274,24,1,298
25/10/2020,Hawke's Bay,0,0,0,0,38,6,0,44
25/10/2020,Hutt Valley,0,0,0,0,19,3,0,22
25/10/2020,Lakes,0,0,0,0,15,1,0,16
25/10/2020,Midcentral,0,0,0,0,27,5,0,32
25/10/2020,Nelson Marlborough,0,0,0,0,37,12,0,49
25/10/2020,Northland,0,0,0,0,26,2,0,28
25/10/2020,South Canterbury,0,0,0,0,15,2,0,17
25/10/2020,Southern,0,0,0,0,186,30,2,216
25/10/2020,Tairawhiti,0,0,0,0,3,1,0,4
25/10/2020,Taranaki,0,0,0,0,14,2,0,16
25/10/2020,Waikato,0,0,0,0,155,39,2,194
25/10/2020,Wairarapa,0,0,0,0,6,2,0,8
25/10/2020,Waitemata,0,0,0,0,225,71,4,296
25/10/2020,West Coast,0,0,0,0,4,1,1,5
25/10/2020,Whanganui,0,0,0,0,8,1,0,9
24/10/2020,Auckland,0,0,0,0,255,51,1,306
24/10/2020,Bay of Plenty,0,0,0,0,34,14,0,48
24/10/2020,Canterbury,0,0,0,0,165,65,12,230
24/10/2020,Capital and Coast,0,0,0,0,74,24,2,98
24/10/2020,Counties Manukau,0,0,0,0,274,24,1,298
24/10/2020,Hawke's Bay,0,0,0,0,38,6,0,44
24/10/2020,Hutt Valley,0,0,0,0,19,3,0,22
24/10/2020,Lakes,0,0,0,0,15,1,0,16
24/10/2020,Midcentral,0,0,0,0,27,5,0,32
24/10/2020,Nelson Marlborough,0,0,0,0,37,12,0,49
24/10/2020,Northland,0,0,0,0,26,2,0,28
24/10/2020,South Canterbury,0,0,0,0,15,2,0,17
24/10/2020,Southern,0,0,0,0,186,30,2,216
24/10/2020,Tairawhiti,0,0,0,0,3,1,0,4
24/10/2020,Taranaki,0,0,0,0,14,2,0,16
24/10/2020,Waikato,0,0,0,0,155,39,2,194
24/10/2020,Wairarapa,0,0,0,0,6,2,0,8
24/10/2020,Waitemata,0,0,0,0,225,71,4,296
24/10/2020,West Coast,0,0,0,0,4,1,1,5
24/10/2020,Whanganui,0,0,0,0,8,1,0,9
23/10/2020,Auckland,4,0,0,4,255,51,1,306
23/10/2020,Bay of Plenty,0,0,0,0,34,14,0,48
23/10/2020,Canterbury,12,0,0,12,165,65,12,230
23/10/2020,Capital and Coast,0,0,0,0,74,24,2,98
23/10/2020,Counties Manukau,2,0,0,2,274,24,1,298
23/10/2020,Hawke's Bay,0,0,0,0,38,6,0,44
23/10/2020,Hutt Valley,0,0,0,0,19,3,0,22
23/10/2020,Lakes,0,0,0,0,15,1,0,16
23/10/2020,Midcentral,0,0,0,0,27,5,0,32
23/10/2020,Nelson Marlborough,0,0,0,0,37,12,0,49
23/10/2020,Northland,0,0,0,0,26,2,0,28
23/10/2020,South Canterbury,0,0,0,0,15,2,0,17
23/10/2020,Southern,0,0,0,0,186,30,2,216
23/10/2020,Tairawhiti,0,0,0,0,3,1,0,4
23/10/2020,Taranaki,0,0,0,0,14,2,0,16
23/10/2020,Waikato,0,0,0,0,155,39,2,194
23/10/2020,Wairarapa,0,0,0,0,6,2,0,8
23/10/2020,Waitemata,0,0,0,0,225,71,4,296
23/10/2020,West Coast,0,0,0,0,4,1,1,5
23/10/2020,Whanganui,0,0,0,0,8,1,0,9
22/10/2020,Auckland,0,0,0,0,251,51,1,302
22/10/2020,Bay of Plenty,0,0,0,0,34,14,0,48
22/10/2020,Canterbury,0,0,0,0,153,65,12,218
22/10/2020,Capital and Coast,0,0,0,0,74,24,2,98
22/10/2020,Counties Manukau,2,0,0,2,272,24,1,296
22/10/2020,Hawke's Bay,0,0,0,0,38,6,0,44
22/10/2020,Hutt Valley,0,0,0,0,19,3,0,22
22/10/2020,Lakes,0,0,0,0,15,1,0,16
22/10/2020,Midcentral,0,0,0,0,27,5,0,32
22/10/2020,Nelson Marlborough,0,0,0,0,37,12,0,49
22/10/2020,Northland,0,0,0,0,26,2,0,28
22/10/2020,South Canterbury,0,0,0,0,15,2,0,17
22/10/2020,Southern,0,0,0,0,186,30,2,216
22/10/2020,Tairawhiti,0,0,0,0,3,1,0,4
22/10/2020,Taranaki,0,0,0,0,14,2,0,16
22/10/2020,Waikato,0,0,0,0,155,39,2,194
22/10/2020,Wairarapa,0,0,0,0,6,2,0,8
22/10/2020,Waitemata,1,0,0,1,225,71,4,296
22/10/2020,West Coast,0,0,0,0,4,1,1,5
22/10/2020,Whanganui,0,0,0,0,8,1,0,9
21/10/2020,Auckland,0,0,0,0,251,51,1,302
21/10/2020,Bay of Plenty,0,0,0,0,34,14,0,48
21/10/2020,Canterbury,0,0,0,0,153,65,12,218
21/10/2020,Capital and Coast,0,0,0,0,74,24,2,98
21/10/2020,Counties Manukau,3,0,0,3,270,24,1,294
21/10/2020,Hawke's Bay,0,0,0,0,38,6,0,44
21/10/2020,Hutt Valley,0,0,0,0,19,3,0,22
21/10/2020,Lakes,0,0,0,0,15,1,0,16
21/10/2020,Midcentral,0,0,0,0,27,5,0,32
21/10/2020,Nelson Marlborough,0,0,0,0,37,12,0,49
21/10/2020,Northland,0,0,0,0,26,2,0,28
21/10/2020,South Canterbury,0,0,0,0,15,2,0,17
21/10/2020,Southern,0,0,0,0,186,30,2,216
21/10/2020,Tairawhiti,0,0,0,0,3,1,0,4
21/10/2020,Taranaki,0,0,0,0,14,2,0,16
21/10/2020,Waikato,0,0,0,0,155,39,2,194
21/10/2020,Wairarapa,0,0,0,0,6,2,0,8
21/10/2020,Waitemata,1,0,0,1,224,71,4,295
21/10/2020,West Coast,0,0,0,0,4,1,1,5
21/10/2020,Whanganui,0,0,0,0,8,1,0,9
20/10/2020,Auckland,1,0,0,1,251,51,1,302
20/10/2020,Bay of Plenty,0,0,0,0,34,14,0,48
20/10/2020,Canterbury,21,0,0,21,153,65,12,218
20/10/2020,Capital and Coast,0,0,0,0,74,24,2,98
20/10/2020,Counties Manukau,0,0,0,0,267,24,1,291
20/10/2020,Hawke's Bay,0,0,0,0,38,6,0,44
20/10/2020,Hutt Valley,0,0,0,0,19,3,0,22
20/10/2020,Lakes,0,0,0,0,15,1,0,16
20/10/2020,Midcentral,0,0,0,0,27,5,0,32
20/10/2020,Nelson Marlborough,0,0,0,0,37,12,0,49
20/10/2020,Northland,0,0,0,0,26,2,0,28
20/10/2020,South Canterbury,0,0,0,0,15,2,0,17
20/10/2020,Southern,0,0,0,0,186,30,2,216
20/10/2020,Tairawhiti,0,0,0,0,3,1,0,4
20/10/2020,Taranaki,0,0,0,0,14,2,0,16
20/10/2020,Waikato,0,0,0,0,155,39,2,194
20/10/2020,Wairarapa,0,0,0,0,6,2,0,8
20/10/2020,Waitemata,0,0,0,0,223,71,4,294
20/10/2020,West Coast,0,0,0,0,4,1,1,5
20/10/2020,Whanganui,0,0,0,0,8,1,0,9
19/10/2020,Auckland,1,0,0,1,250,51,1,301
19/10/2020,Bay of Plenty,0,0,0,0,34,14,0,48
19/10/2020,Canterbury,0,0,0,0,132,65,12,197
19/10/2020,Capital and Coast,0,0,0,0,74,24,2,98
19/10/2020,Counties Manukau,0,0,0,0,267,24,1,291
19/10/2020,Hawke's Bay,0,0,0,0,38,6,0,44
19/10/2020,Hutt Valley,0,0,0,0,19,3,0,22
19/10/2020,Lakes,0,0,0,0,15,1,0,16
19/10/2020,Midcentral,0,0,0,0,27,5,0,32
19/10/2020,Nelson Marlborough,0,0,0,0,37,12,0,49
19/10/2020,Northland,0,0,0,0,26,2,0,28
19/10/2020,South Canterbury,0,0,0,0,15,2,0,17
19/10/2020,Southern,0,0,0,0,186,30,2,216
19/10/2020,Tairawhiti,0,0,0,0,3,1,0,4
19/10/2020,Taranaki,0,0,0,0,14,2,0,16
19/10/2020,Waikato,0,0,0,0,155,39,2,194
19/10/2020,Wairarapa,0,0,0,0,6,2,0,8
19/10/2020,Waitemata,0,0,0,0,223,71,4,294
19/10/2020,West Coast,0,0,0,0,4,1,1,5
19/10/2020,Whanganui,0,0,0,0,8,1,0,9
18/10/2020,Auckland,0,0,0,0,249,51,1,300
18/10/2020,Bay of Plenty,0,0,0,0,34,14,0,48
18/10/2020,Canterbury,0,0,0,0,132,65,12,197
18/10/2020,Capital and Coast,0,0,0,0,74,24,2,98
18/10/2020,Counties Manukau,1,0,0,1,267,24,1,291
18/10/2020,Hawke's Bay,0,0,0,0,38,6,0,44
18/10/2020,Hutt Valley,0,0,0,0,19,3,0,22
18/10/2020,Lakes,0,0,0,0,15,1,0,16
18/10/2020,Midcentral,0,0,0,0,27,5,0,32
18/10/2020,Nelson Marlborough,0,0,0,0,37,12,0,49
18/10/2020,Northland,0,0,0,0,26,2,0,28
18/10/2020,South Canterbury,0,0,0,0,15,2,0,17
18/10/2020,Southern,0,0,0,0,186,30,2,216
18/10/2020,Tairawhiti,0,0,0,0,3,1,0,4
18/10/2020,Taranaki,0,0,0,0,14,2,0,16
18/10/2020,Waikato,0,0,0,0,155,39,2,194
18/10/2020,Wairarapa,0,0,0,0,6,2,0,8
18/10/2020,Waitemata,0,0,0,0,223,71,4,294
18/10/2020,West Coast,0,0,0,0,4,1,1,5
18/10/2020,Whanganui,0,0,0,0,8,1,0,9
17/10/2020,Auckland,2,0,0,2,249,51,1,300
17/10/2020,Bay of Plenty,0,0,0,0,34,14,0,48
17/10/2020,Canterbury,0,0,0,0,132,65,12,197
17/10/2020,Capital and Coast,0,0,0,0,74,24,2,98
17/10/2020,Counties Manukau,1,0,0,1,266,24,1,290
17/10/2020,Hawke's Bay,0,0,0,0,38,6,0,44
17/10/2020,Hutt Valley,0,0,0,0,19,3,0,22
17/10/2020,Lakes,0,0,0,0,15,1,0,16
17/10/2020,Midcentral,0,0,0,0,27,5,0,32
17/10/2020,Nelson Marlborough,0,0,0,0,37,12,0,49
17/10/2020,Northland,0,0,0,0,26,2,0,28
17/10/2020,South Canterbury,0,0,0,0,15,2,0,17
17/10/2020,Southern,0,0,0,0,186,30,2,216
17/10/2020,Tairawhiti,0,0,0,0,3,1,0,4
17/10/2020,Taranaki,0,0,0,0,14,2,0,16
17/10/2020,Waikato,0,0,0,0,155,39,2,194
17/10/2020,Wairarapa,0,0,0,0,6,2,0,8
17/10/2020,Waitemata,1,0,0,1,223,71,4,294
17/10/2020,West Coast,0,0,0,0,4,1,1,5
17/10/2020,Whanganui,0,0,0,0,8,1,0,9
16/10/2020,Auckland,0,0,0,0,247,51,1,298
16/10/2020,Bay of Plenty,0,0,0,0,34,14,0,48
16/10/2020,Canterbury,1,0,0,1,132,65,12,197
16/10/2020,Capital and Coast,0,0,0,0,74,24,2,98
16/10/2020,Counties Manukau,0,0,0,0,265,24,1,289
16/10/2020,Hawke's Bay,0,0,0,0,38,6,0,44
16/10/2020,Hutt Valley,0,0,0,0,19,3,0,22
16/10/2020,Lakes,0,0,0,0,15,1,0,16
16/10/2020,Midcentral,0,0,0,0,27,5,0,32
16/10/2020,Nelson Marlborough,0,0,0,0,37,12,0,49
16/10/2020,Northland,0,0,0,0,26,2,0,28
16/10/2020,South Canterbury,0,0,0,0,15,2,0,17
16/10/2020,Southern,0,0,0,0,186,30,2,216
16/10/2020,Tairawhiti,0,0,0,0,3,1,0,4
16/10/2020,Taranaki,0,0,0,0,14,2,0,16
16/10/2020,Waikato,0,0,0,0,155,39,2,194
16/10/2020,Wairarapa,0,0,0,0,6,2,0,8
16/10/2020,Waitemata,0,0,0,0,222,71,4,293
16/10/2020,West Coast,0,0,0,0,4,1,1,5
16/10/2020,Whanganui,0,0,0,0,8,1,0,9
15/10/2020,Auckland,3,0,0,3,247,51,1,298
15/10/2020,Bay of Plenty,0,0,0,0,34,14,0,48
15/10/2020,Canterbury,1,0,0,1,131,65,12,196
15/10/2020,Capital and Coast,1,0,0,1,74,24,2,98
15/10/2020,Counties Manukau,0,0,0,0,265,24,1,289
15/10/2020,Hawke's Bay,0,0,0,0,38,6,0,44
15/10/2020,Hutt Valley,0,0,0,0,19,3,0,22
15/10/2020,Lakes,0,0,0,0,15,1,0,16
15/10/2020,Midcentral,0,0,0,0,27,5,0,32
15/10/2020,Nelson Marlborough,0,0,0,0,37,12,0,49
15/10/2020,Northland,0,0,0,0,26,2,0,28
15/10/2020,South Canterbury,0,0,0,0,15,2,0,17
15/10/2020,Southern,0,0,0,0,186,30,2,216
15/10/2020,Tairawhiti,0,0,0,0,3,1,0,4
15/10/2020,Taranaki,0,0,0,0,14,2,0,16
15/10/2020,Waikato,0,0,0,0,155,39,2,194
15/10/2020,Wairarapa,0,0,0,0,6,2,0,8
15/10/2020,Waitemata,0,0,0,0,222,71,4,293
15/10/2020,West Coast,0,0,0,0,4,1,1,5
15/10/2020,Whanganui,0,0,0,0,8,1,0,9
14/10/2020,Auckland,0,0,0,0,244,51,1,295
14/10/2020,Bay of Plenty,0,0,0,0,34,14,0,48
14/10/2020,Canterbury,1,0,0,1,130,65,12,195
14/10/2020,Capital and Coast,0,0,0,0,73,24,2,97
14/10/2020,Counties Manukau,0,0,0,0,265,24,1,289
14/10/2020,Hawke's Bay,0,0,0,0,38,6,0,44
14/10/2020,Hutt Valley,0,0,0,0,19,3,0,22
14/10/2020,Lakes,0,0,0,0,15,1,0,16
14/10/2020,Midcentral,0,0,0,0,27,5,0,32
14/10/2020,Nelson Marlborough,0,0,0,0,37,12,0,49
14/10/2020,Northland,0,0,0,0,26,2,0,28
14/10/2020,South Canterbury,0,0,0,0,15,2,0,17
14/10/2020,Southern,0,0,0,0,186,30,2,216
14/10/2020,Tairawhiti,0,0,0,0,3,1,0,4
14/10/2020,Taranaki,0,0,0,0,14,2,0,16
14/10/2020,Waikato,0,0,0,0,155,39,2,194
14/10/2020,Wairarapa,0,0,0,0,6,2,0,8
14/10/2020,Waitemata,0,0,0,0,222,71,4,293
14/10/2020,West Coast,0,0,0,0,4,1,1,5
14/10/2020,Whanganui,0,0,0,0,8,1,0,9
13/10/2020,Auckland,0,0,0,0,244,51,1,295
13/10/2020,Bay of Plenty,0,0,0,0,34,14,0,48
13/10/2020,Canterbury,0,0,0,0,129,65,12,194
13/10/2020,Capital and Coast,0,0,0,0,73,24,2,97
13/10/2020,Counties Manukau,2,0,0,2,265,24,1,289
13/10/2020,Hawke's Bay,0,0,0,0,38,6,0,44
13/10/2020,Hutt Valley,0,0,0,0,19,3,0,22
13/10/2020,Lakes,0,0,0,0,15,1,0,16
13/10/2020,Midcentral,0,0,0,0,27,5,0,32
13/10/2020,Nelson Marlborough,0,0,0,0,37,12,0,49
13/10/2020,Northland,0,0,0,0,26,2,0,28
13/10/2020,South Canterbury,0,0,0,0,15,2,0,17
13/10/2020,Southern,0,0,0,0,186,30,2,216
13/10/2020,Tairawhiti,0,0,0,0,3,1,0,4
13/10/2020,Taranaki,0,0,0,0,14,2,0,16
13/10/2020,Waikato,0,0,0,0,155,39,2,194
13/10/2020,Wairarapa,0,0,0,0,6,2,0,8
13/10/2020,Waitemata,0,0,0,0,222,71,4,293
13/10/2020,West Coast,0,0,0,0,4,1,1,5
13/10/2020,Whanganui,0,0,0,0,8,1,0,9
12/10/2020,Auckland,0,0,0,0,244,51,1,295
12/10/2020,Bay of Plenty,0,0,0,0,34,14,0,48
12/10/2020,Canterbury,1,0,0,1,129,65,12,194
12/10/2020,Capital and Coast,0,0,0,0,73,24,2,97
12/10/2020,Counties Manukau,0,0,0,0,263,24,1,287
12/10/2020,Hawke's Bay,0,0,0,0,38,6,0,44
12/10/2020,Hutt Valley,0,0,0,0,19,3,0,22
12/10/2020,Lakes,0,0,0,0,15,1,0,16
12/10/2020,Midcentral,0,0,0,0,27,5,0,32
12/10/2020,Nelson Marlborough,0,0,0,0,37,12,0,49
12/10/2020,Northland,0,0,0,0,26,2,0,28
12/10/2020,South Canterbury,0,0,0,0,15,2,0,17
12/10/2020,Southern,0,0,0,0,186,30,2,216
12/10/2020,Tairawhiti,0,0,0,0,3,1,0,4
12/10/2020,Taranaki,0,0,0,0,14,2,0,16
12/10/2020,Waikato,0,0,0,0,155,39,2,194
12/10/2020,Wairarapa,0,0,0,0,6,2,0,8
12/10/2020,Waitemata,0,0,0,0,222,71,4,293
12/10/2020,West Coast,0,0,0,0,4,1,1,5
12/10/2020,Whanganui,0,0,0,0,8,1,0,9
11/10/2020,Auckland,0,0,0,0,244,51,1,295
11/10/2020,Bay of Plenty,0,0,0,0,34,14,0,48
11/10/2020,Canterbury,0,0,0,0,128,65,12,193
11/10/2020,Capital and Coast,0,0,0,0,73,24,2,97
11/10/2020,Counties Manukau,2,0,0,2,263,24,1,287
11/10/2020,Hawke's Bay,0,0,0,0,38,6,0,44
11/10/2020,Hutt Valley,0,0,0,0,19,3,0,22
11/10/2020,Lakes,0,0,0,0,15,1,0,16
11/10/2020,Midcentral,0,0,0,0,27,5,0,32
11/10/2020,Nelson Marlborough,0,0,0,0,37,12,0,49
11/10/2020,Northland,0,0,0,0,26,2,0,28
11/10/2020,South Canterbury,0,0,0,0,15,2,0,17
11/10/2020,Southern,0,0,0,0,186,30,2,216
11/10/2020,Tairawhiti,0,0,0,0,3,1,0,4
11/10/2020,Taranaki,0,0,0,0,14,2,0,16
11/10/2020,Waikato,0,0,0,0,155,39,2,194
11/10/2020,Wairarapa,0,0,0,0,6,2,0,8
11/10/2020,Waitemata,0,0,0,0,222,71,4,293
11/10/2020,West Coast,0,0,0,0,4,1,1,5
11/10/2020,Whanganui,0,0,0,0,8,1,0,9
10/10/2020,Auckland,0,0,0,0,244,51,1,295
10/10/2020,Bay of Plenty,0,0,0,0,34,14,0,48
10/10/2020,Canterbury,0,0,0,0,128,65,12,193
10/10/2020,Capital and Coast,0,0,0,0,73,24,2,97
10/10/2020,Counties Manukau,0,0,0,0,261,24,1,285
10/10/2020,Hawke's Bay,0,0,0,0,38,6,0,44
10/10/2020,Hutt Valley,0,0,0,0,19,3,0,22
10/10/2020,Lakes,0,0,0,0,15,1,0,16
10/10/2020,Midcentral,0,0,0,0,27,5,0,32
10/10/2020,Nelson Marlborough,0,0,0,0,37,12,0,49
10/10/2020,Northland,0,0,0,0,26,2,0,28
10/10/2020,South Canterbury,0,0,0,0,15,2,0,17
10/10/2020,Southern,0,0,0,0,186,30,2,216
10/10/2020,Tairawhiti,0,0,0,0,3,1,0,4
10/10/2020,Taranaki,0,0,0,0,14,2,0,16
10/10/2020,Waikato,0,0,0,0,155,39,2,194
10/10/2020,Wairarapa,0,0,0,0,6,2,0,8
10/10/2020,Waitemata,0,0,0,0,222,71,4,293
10/10/2020,West Coast,0,0,0,0,4,1,1,5
10/10/2020,Whanganui,0,0,0,0,8,1,0,9
09/10/2020,Auckland,0,0,0,0,244,51,1,295
09/10/2020,Bay of Plenty,0,0,0,0,34,14,0,48
09/10/2020,Canterbury,0,0,0,0,128,65,12,193
09/10/2020,Capital and Coast,0,0,0,0,73,24,2,97
09/10/2020,Counties Manukau,4,0,0,4,261,24,1,285
09/10/2020,Hawke's Bay,0,0,0,0,38,6,0,44
09/10/2020,Hutt Valley,0,0,0,0,19,3,0,22
09/10/2020,Lakes,0,0,0,0,15,1,0,16
09/10/2020,Midcentral,0,0,0,0,27,5,0,32
09/10/2020,Nelson Marlborough,0,0,0,0,37,12,0,49
09/10/2020,Northland,0,0,0,0,26,2,0,28
09/10/2020,South Canterbury,0,0,0,0,15,2,0,17
09/10/2020,Southern,0,0,0,0,186,30,2,216
09/10/2020,Tairawhiti,0,0,0,0,3,1,0,4
09/10/2020,Taranaki,0,0,0,0,14,2,0,16
09/10/2020,Waikato,0,0,0,0,155,39,2,194
09/10/2020,Wairarapa,0,0,0,0,6,2,0,8
09/10/2020,Waitemata,0,0,0,0,222,71,4,293
09/10/2020,West Coast,0,0,0,0,4,1,1,5
09/10/2020,Whanganui,0,0,0,0,8,1,0,9
08/10/2020,Auckland,2,0,0,2,244,51,1,295
08/10/2020,Bay of Plenty,0,0,0,0,34,14,0,48
08/10/2020,Canterbury,0,0,0,0,128,65,12,193
08/10/2020,Capital and Coast,0,0,0,0,73,24,2,97
08/10/2020,Counties Manukau,1,0,0,1,257,24,1,281
08/10/2020,Hawke's Bay,0,0,0,0,38,6,0,44
08/10/2020,Hutt Valley,0,0,0,0,19,3,0,22
08/10/2020,Lakes,0,0,0,0,15,1,0,16
08/10/2020,Midcentral,0,0,0,0,27,5,0,32
08/10/2020,Nelson Marlborough,0,0,0,0,37,12,0,49
08/10/2020,Northland,0,0,0,0,26,2,0,28
08/10/2020,South Canterbury,0,0,0,0,15,2,0,17
08/10/2020,Southern,0,0,0,0,186,30,2,216
08/10/2020,Tairawhiti,0,0,0,0,3,1,0,4
08/10/2020,Taranaki,0,0,0,0,14,2,0,16
08/10/2020,Waikato,0,0,0,0,155,39,2,194
08/10/2020,Wairarapa,0,0,0,0,6,2,0,8
08/10/2020,Waitemata,0,0,0,0,222,71,4,293
08/10/2020,West Coast,0,0,0,0,4,1,1,5
08/10/2020,Whanganui,0,0,0,0,8,1,0,9
07/10/2020,Auckland,1,0,0,1,242,51,1,293
07/10/2020,Bay of Plenty,0,0,0,0,34,14,0,48
07/10/2020,Canterbury,1,0,0,1,128,65,12,193
07/10/2020,Capital and Coast,0,0,0,0,73,24,2,97
07/10/2020,Counties Manukau,1,0,0,1,256,24,1,280
07/10/2020,Hawke's Bay,0,0,0,0,38,6,0,44
07/10/2020,Hutt Valley,0,0,0,0,19,3,0,22
07/10/2020,Lakes,0,0,0,0,15,1,0,16
07/10/2020,Midcentral,0,0,0,0,27,5,0,32
07/10/2020,Nelson Marlborough,0,0,0,0,37,12,0,49
07/10/2020,Northland,0,0,0,0,26,2,0,28
07/10/2020,South Canterbury,0,0,0,0,15,2,0,17
07/10/2020,Southern,0,0,0,0,186,30,2,216
07/10/2020,Tairawhiti,0,0,0,0,3,1,0,4
07/10/2020,Taranaki,0,0,0,0,14,2,0,16
07/10/2020,Waikato,0,0,0,0,155,39,2,194
07/10/2020,Wairarapa,0,0,0,0,6,2,0,8
07/10/2020,Waitemata,0,0,0,0,222,71,4,293
07/10/2020,West Coast,0,0,0,0,4,1,1,5
07/10/2020,Whanganui,0,0,0,0,8,1,0,9
06/10/2020,Auckland,0,0,0,0,241,51,1,292
06/10/2020,Bay of Plenty,0,0,0,0,34,14,0,48
06/10/2020,Canterbury,0,0,0,0,127,65,12,192
06/10/2020,Capital and Coast,0,0,0,0,73,24,2,97
06/10/2020,Counties Manukau,2,0,0,2,255,24,1,279
06/10/2020,Hawke's Bay,0,0,0,0,38,6,0,44
06/10/2020,Hutt Valley,0,0,0,0,19,3,0,22
06/10/2020,Lakes,0,0,0,0,15,1,0,16
06/10/2020,Midcentral,0,0,0,0,27,5,0,32
06/10/2020,Nelson Marlborough,0,0,0,0,37,12,0,49
06/10/2020,Northland,0,0,0,0,26,2,0,28
06/10/2020,South Canterbury,0,0,0,0,15,2,0,17
06/10/2020,Southern,0,0,0,0,186,30,2,216
06/10/2020,Tairawhiti,0,0,0,0,3,1,0,4
06/10/2020,Taranaki,0,0,0,0,14,2,0,16
06/10/2020,Waikato,0,0,0,0,155,39,2,194
06/10/2020,Wairarapa,0,0,0,0,6,2,0,8
06/10/2020,Waitemata,0,0,0,0,222,71,4,293
06/10/2020,West Coast,0,0,0,0,4,1,1,5
06/10/2020,Whanganui,0,0,0,0,8,1,0,9
05/10/2020,Auckland,1,0,0,1,241,51,1,292
05/10/2020,Bay of Plenty,0,0,0,0,34,14,0,48
05/10/2020,Canterbury,0,0,0,0,127,65,12,192
05/10/2020,Capital and Coast,0,0,0,0,73,24,2,97
05/10/2020,Counties Manukau,2,0,0,2,253,24,1,277
05/10/2020,Hawke's Bay,0,0,0,0,38,6,0,44
05/10/2020,Hutt Valley,0,0,0,0,19,3,0,22
05/10/2020,Lakes,0,0,0,0,15,1,0,16
05/10/2020,Midcentral,0,0,0,0,27,5,0,32
05/10/2020,Nelson Marlborough,0,0,0,0,37,12,0,49
05/10/2020,Northland,0,0,0,0,26,2,0,28
05/10/2020,South Canterbury,0,0,0,0,15,2,0,17
05/10/2020,Southern,0,0,0,0,186,30,2,216
05/10/2020,Tairawhiti,0,0,0,0,3,1,0,4
05/10/2020,Taranaki,0,0,0,0,14,2,0,16
05/10/2020,Waikato,0,0,0,0,155,39,2,194
05/10/2020,Wairarapa,0,0,0,0,6,2,0,8
05/10/2020,Waitemata,0,0,0,0,222,71,4,293
05/10/2020,West Coast,0,0,0,0,4,1,1,5
05/10/2020,Whanganui,0,0,0,0,8,1,0,9
04/10/2020,Auckland,1,0,0,1,240,51,1,291
04/10/2020,Bay of Plenty,0,0,0,0,34,14,0,48
04/10/2020,Canterbury,0,0,0,0,127,65,12,192
04/10/2020,Capital and Coast,0,0,0,0,73,24,2,97
04/10/2020,Counties Manukau,1,0,0,1,251,24,1,275
04/10/2020,Hawke's Bay,0,0,0,0,38,6,0,44
04/10/2020,Hutt Valley,0,0,0,0,19,3,0,22
04/10/2020,Lakes,0,0,0,0,15,1,0,16
04/10/2020,Midcentral,0,0,0,0,27,5,0,32
04/10/2020,Nelson Marlborough,0,0,0,0,37,12,0,49
04/10/2020,Northland,0,0,0,0,26,2,0,28
04/10/2020,South Canterbury,0,0,0,0,15,2,0,17
04/10/2020,Southern,0,0,0,0,186,30,2,216
04/10/2020,Tairawhiti,0,0,0,0,3,1,0,4
04/10/2020,Taranaki,0,0,0,0,14,2,0,16
04/10/2020,Waikato,0,0,0,0,155,39,2,194
04/10/2020,Wairarapa,0,0,0,0,6,2,0,8
04/10/2020,Waitemata,0,0,0,0,222,71,4,293
04/10/2020,West Coast,0,0,0,0,4,1,1,5
04/10/2020,Whanganui,0,0,0,0,8,1,0,9
03/10/2020,Auckland,1,0,0,1,239,51,1,290
03/10/2020,Bay of Plenty,0,0,0,0,34,14,0,48
03/10/2020,Canterbury,0,0,0,0,127,65,12,192
03/10/2020,Capital and Coast,0,0,0,0,73,24,2,97
03/10/2020,Counties Manukau,3,0,0,3,250,24,1,274
03/10/2020,Hawke's Bay,0,0,0,0,38,6,0,44
03/10/2020,Hutt Valley,0,0,0,0,19,3,0,22
03/10/2020,Lakes,0,0,0,0,15,1,0,16
03/10/2020,Midcentral,0,0,0,0,27,5,0,32
03/10/2020,Nelson Marlborough,0,0,0,0,37,12,0,49
03/10/2020,Northland,0,0,0,0,26,2,0,28
03/10/2020,South Canterbury,0,0,0,0,15,2,0,17
03/10/2020,Southern,0,0,0,0,186,30,2,216
03/10/2020,Tairawhiti,0,0,0,0,3,1,0,4
03/10/2020,Taranaki,0,0,0,0,14,2,0,16
03/10/2020,Waikato,0,0,0,0,155,39,2,194
03/10/2020,Wairarapa,0,0,0,0,6,2,0,8
03/10/2020,Waitemata,0,0,0,0,222,71,4,293
03/10/2020,West Coast,0,0,0,0,4,1,1,5
03/10/2020,Whanganui,0,0,0,0,8,1,0,9
02/10/2020,Auckland,0,0,0,0,238,51,1,289
02/10/2020,Bay of Plenty,0,0,0,0,34,14,0,48
02/10/2020,Canterbury,1,0,0,1,127,65,12,192
02/10/2020,Capital and Coast,0,0,0,0,73,24,2,97
02/10/2020,Counties Manukau,1,0,0,1,247,24,1,271
02/10/2020,Hawke's Bay,0,0,0,0,38,6,0,44
02/10/2020,Hutt Valley,0,0,0,0,19,3,0,22
02/10/2020,Lakes,0,0,0,0,15,1,0,16
02/10/2020,Midcentral,0,0,0,0,27,5,0,32
02/10/2020,Nelson Marlborough,0,0,0,0,37,12,0,49
02/10/2020,Northland,0,0,0,0,26,2,0,28
02/10/2020,South Canterbury,0,0,0,0,15,2,0,17
02/10/2020,Southern,0,0,0,0,186,30,2,216
02/10/2020,Tairawhiti,0,0,0,0,3,1,0,4
02/10/2020,Taranaki,0,0,0,0,14,2,0,16
02/10/2020,Waikato,0,0,0,0,155,39,2,194
02/10/2020,Wairarapa,0,0,0,0,6,2,0,8
02/10/2020,Waitemata,0,0,0,0,222,71,4,293
02/10/2020,West Coast,0,0,0,0,4,1,1,5
02/10/2020,Whanganui,0,0,0,0,8,1,0,9
01/10/2020,Auckland,6,0,0,6,238,51,1,289
01/10/2020,Bay of Plenty,0,0,0,0,34,14,0,48
01/10/2020,Canterbury,0,0,0,0,126,65,12,191
01/10/2020,Capital and Coast,0,0,0,0,73,24,2,97
01/10/2020,Counties Manukau,0,0,0,0,246,24,1,270
01/10/2020,Hawke's Bay,0,0,0,0,38,6,0,44
01/10/2020,Hutt Valley,0,0,0,0,19,3,0,22
01/10/2020,Lakes,0,0,0,0,15,1,0,16
01/10/2020,Midcentral,0,0,0,0,27,5,0,32
01/10/2020,Nelson Marlborough,0,0,0,0,37,12,0,49
01/10/2020,Northland,0,0,0,0,26,2,0,28
01/10/2020,South Canterbury,0,0,0,0,15,2,0,17
01/10/2020,Southern,0,0,0,0,186,30,2,216
01/10/2020,Tairawhiti,0,0,0,0,3,1,0,4
01/10/2020,Taranaki,0,0,0,0,14,2,0,16
01/10/2020,Waikato,0,0,0,0,155,39,2,194
01/10/2020,Wairarapa,0,0,0,0,6,2,0,8
01/10/2020,Waitemata,0,0,0,0,222,71,4,293
01/10/2020,West Coast,0,0,0,0,4,1,1,5
01/10/2020,Whanganui,0,0,0,0,8,1,0,9
30/09/2020,Auckland,4,0,0,4,232,51,1,283
30/09/2020,Bay of Plenty,0,0,0,0,34,14,0,48
30/09/2020,Canterbury,1,0,0,1,126,65,12,191
30/09/2020,Capital and Coast,0,0,0,0,73,24,2,97
30/09/2020,Counties Manukau,1,0,0,1,246,24,1,270
30/09/2020,Hawke's Bay,0,0,0,0,38,6,0,44
30/09/2020,Hutt Valley,0,0,0,0,19,3,0,22
30/09/2020,Lakes,0,0,0,0,15,1,0,16
30/09/2020,Midcentral,0,0,0,0,27,5,0,32
30/09/2020,Nelson Marlborough,0,0,0,0,37,12,0,49
30/09/2020,Northland,0,0,0,0,26,2,0,28
30/09/2020,South Canterbury,0,0,0,0,15,2,0,17
30/09/2020,Southern,0,0,0,0,186,30,2,216
30/09/2020,Tairawhiti,0,0,0,0,3,1,0,4
30/09/2020,Taranaki,0,0,0,0,14,2,0,16
30/09/2020,Waikato,0,0,0,0,155,39,2,194
30/09/2020,Wairarapa,0,0,0,0,6,2,0,8
30/09/2020,Waitemata,0,0,0,0,222,71,4,293
30/09/2020,West Coast,0,0,0,0,4,1,1,5
30/09/2020,Whanganui,0,0,0,0,8,1,0,9
29/09/2020,Auckland,0,0,0,0,228,51,1,279
29/09/2020,Bay of Plenty,0,0,0,0,34,14,0,48
29/09/2020,Canterbury,0,0,0,0,125,65,12,190
29/09/2020,Capital and Coast,0,0,0,0,73,24,2,97
29/09/2020,Counties Manukau,0,0,0,0,245,24,1,269
29/09/2020,Hawke's Bay,0,0,0,0,38,6,0,44
29/09/2020,Hutt Valley,0,0,0,0,19,3,0,22
29/09/2020,Lakes,0,0,0,0,15,1,0,16
29/09/2020,Midcentral,0,0,0,0,27,5,0,32
29/09/2020,Nelson Marlborough,0,0,0,0,37,12,0,49
29/09/2020,Northland,0,0,0,0,26,2,0,28
29/09/2020,South Canterbury,0,0,0,0,15,2,0,17
29/09/2020,Southern,0,0,0,0,186,30,2,216
29/09/2020,Tairawhiti,0,0,0,0,3,1,0,4
29/09/2020,Taranaki,0,0,0,0,14,2,0,16
29/09/2020,Waikato,0,0,0,0,155,39,2,194
29/09/2020,Wairarapa,0,0,0,0,6,2,0,8
29/09/2020,Waitemata,0,0,0,0,222,71,4,293
29/09/2020,West Coast,0,0,0,0,4,1,1,5
29/09/2020,Whanganui,0,0,0,0,8,1,0,9
28/09/2020,Auckland,1,0,0,1,228,51,1,279
28/09/2020,Bay of Plenty,0,0,0,0,34,14,0,48
28/09/2020,Canterbury,0,0,0,0,125,65,12,190
28/09/2020,Capital and Coast,0,0,0,0,73,24,2,97
28/09/2020,Counties Manukau,0,0,0,0,245,24,1,269
28/09/2020,Hawke's Bay,0,0,0,0,38,6,0,44
28/09/2020,Hutt Valley,0,0,0,0,19,3,0,22
28/09/2020,Lakes,0,0,0,0,15,1,0,16
28/09/2020,Midcentral,0,0,0,0,27,5,0,32
28/09/2020,Nelson Marlborough,0,0,0,0,37,12,0,49
28/09/2020,Northland,0,0,0,0,26,2,0,28
28/09/2020,South Canterbury,0,0,0,0,15,2,0,17
28/09/2020,Southern,0,0,0,0,186,30,2,216
28/09/2020,Tairawhiti,0,0,0,0,3,1,0,4
28/09/2020,Taranaki,0,0,0,0,14,2,0,16
28/09/2020,Waikato,0,0,0,0,155,39,2,194
28/09/2020,Wairarapa,0,0,0,0,6,2,0,8
28/09/2020,Waitemata,0,0,0,0,222,71,4,293
28/09/2020,West Coast,0,0,0,0,4,1,1,5
28/09/2020,Whanganui,0,0,0,0,8,1,0,9
27/09/2020,Auckland,0,0,0,0,227,51,1,278
27/09/2020,Bay of Plenty,0,0,0,0,34,14,0,48
27/09/2020,Canterbury,0,0,0,0,125,65,12,190
27/09/2020,Capital and Coast,0,0,0,0,73,24,2,97
27/09/2020,Counties Manukau,2,0,0,2,245,24,1,269
27/09/2020,Hawke's Bay,0,0,0,0,38,6,0,44
27/09/2020,Hutt Valley,0,0,0,0,19,3,0,22
27/09/2020,Lakes,0,0,0,0,15,1,0,16
27/09/2020,Midcentral,0,0,0,0,27,5,0,32
27/09/2020,Nelson Marlborough,0,0,0,0,37,12,0,49
27/09/2020,Northland,0,0,0,0,26,2,0,28
27/09/2020,South Canterbury,0,0,0,0,15,2,0,17
27/09/2020,Southern,0,0,0,0,186,30,2,216
27/09/2020,Tairawhiti,0,0,0,0,3,1,0,4
27/09/2020,Taranaki,0,0,0,0,14,2,0,16
27/09/2020,Waikato,0,0,0,0,155,39,2,194
27/09/2020,Wairarapa,0,0,0,0,6,2,0,8
27/09/2020,Waitemata,0,0,0,0,222,71,4,293
27/09/2020,West Coast,0,0,0,0,4,1,1,5
27/09/2020,Whanganui,0,0,0,0,8,1,0,9
26/09/2020,Auckland,2,0,0,2,227,51,1,278
26/09/2020,Bay of Plenty,0,0,0,0,34,14,0,48
26/09/2020,Canterbury,0,0,0,0,125,65,12,190
26/09/2020,Capital and Coast,0,0,0,0,73,24,2,97
26/09/2020,Counties Manukau,0,0,0,0,243,24,1,267
26/09/2020,Hawke's Bay,0,0,0,0,38,6,0,44
26/09/2020,Hutt Valley,0,0,0,0,19,3,0,22
26/09/2020,Lakes,0,0,0,0,15,1,0,16
26/09/2020,Midcentral,0,0,0,0,27,5,0,32
26/09/2020,Nelson Marlborough,0,0,0,0,37,12,0,49
26/09/2020,Northland,0,0,0,0,26,2,0,28
26/09/2020,South Canterbury,0,0,0,0,15,2,0,17
26/09/2020,Southern,0,0,0,0,186,30,2,216
26/09/2020,Tairawhiti,0,0,0,0,3,1,0,4
26/09/2020,Taranaki,0,0,0,0,14,2,0,16
26/09/2020,Waikato,0,0,0,0,155,39,2,194
26/09/2020,Wairarapa,0,0,0,0,6,2,0,8
26/09/2020,Waitemata,0,0,0,0,222,71,4,293
26/09/2020,West Coast,0,0,0,0,4,1,1,5
26/09/2020,Whanganui,0,0,0,0,8,1,0,9
25/09/2020,Auckland,1,0,0,1,225,51,1,276
25/09/2020,Bay of Plenty,0,0,0,0,34,14,0,48
25/09/2020,Canterbury,0,0,0,0,125,65,12,190
25/09/2020,Capital and Coast,0,0,0,0,73,24,2,97
25/09/2020,Counties Manukau,0,0,0,0,243,24,1,267
25/09/2020,Hawke's Bay,0,0,0,0,38,6,0,44
25/09/2020,Hutt Valley,0,0,0,0,19,3,0,22
25/09/2020,Lakes,0,0,0,0,15,1,0,16
25/09/2020,Midcentral,0,0,0,0,27,5,0,32
25/09/2020,Nelson Marlborough,0,0,0,0,37,12,0,49
25/09/2020,Northland,0,0,0,0,26,2,0,28
25/09/2020,South Canterbury,0,0,0,0,15,2,0,17
25/09/2020,Southern,0,0,0,0,186,30,2,216
25/09/2020,Tairawhiti,0,0,0,0,3,1,0,4
25/09/2020,Taranaki,0,0,0,0,14,2,0,16
25/09/2020,Waikato,0,0,0,0,155,39,2,194
25/09/2020,Wairarapa,0,0,0,0,6,2,0,8
25/09/2020,Waitemata,0,0,0,0,222,71,4,293
25/09/2020,West Coast,0,0,0,0,4,1,1,5
25/09/2020,Whanganui,0,0,0,0,8,1,0,9
24/09/2020,Auckland,1,0,0,1,224,51,1,275
24/09/2020,Bay of Plenty,0,0,0,0,34,14,0,48
24/09/2020,Canterbury,0,0,0,0,125,65,12,190
24/09/2020,Capital and Coast,0,0,0,0,73,24,2,97
24/09/2020,Counties Manukau,0,0,0,0,243,24,1,267
24/09/2020,Hawke's Bay,0,0,0,0,38,6,0,44
24/09/2020,Hutt Valley,0,0,0,0,19,3,0,22
24/09/2020,Lakes,0,0,0,0,15,1,0,16
24/09/2020,Midcentral,0,0,0,0,27,5,0,32
24/09/2020,Nelson Marlborough,0,0,0,0,37,12,0,49
24/09/2020,Northland,0,0,0,0,26,2,0,28
24/09/2020,South Canterbury,0,0,0,0,15,2,0,17
24/09/2020,Southern,0,0,0,0,186,30,2,216
24/09/2020,Tairawhiti,0,0,0,0,3,1,0,4
24/09/2020,Taranaki,0,0,0,0,14,2,0,16
24/09/2020,Waikato,0,0,0,0,155,39,2,194
24/09/2020,Wairarapa,0,0,0,0,6,2,0,8
24/09/2020,Waitemata,1,0,0,1,222,71,4,293
24/09/2020,West Coast,0,0,0,0,4,1,1,5
24/09/2020,Whanganui,0,0,0,0,8,1,0,9
23/09/2020,Auckland,1,0,0,1,223,51,1,274
23/09/2020,Bay of Plenty,0,0,0,0,34,14,0,48
23/09/2020,Canterbury,0,0,0,0,125,65,12,190
23/09/2020,Capital and Coast,0,0,0,0,73,24,2,97
23/09/2020,Counties Manukau,2,0,0,2,243,24,1,267
23/09/2020,Hawke's Bay,0,0,0,0,38,6,0,44
23/09/2020,Hutt Valley,0,0,0,0,19,3,0,22
23/09/2020,Lakes,0,0,0,0,15,1,0,16
23/09/2020,Midcentral,0,0,0,0,27,5,0,32
23/09/2020,Nelson Marlborough,0,0,0,0,37,12,0,49
23/09/2020,Northland,0,0,0,0,26,2,0,28
23/09/2020,South Canterbury,0,0,0,0,15,2,0,17
23/09/2020,Southern,0,0,0,0,186,30,2,216
23/09/2020,Tairawhiti,0,0,0,0,3,1,0,4
23/09/2020,Taranaki,0,0,0,0,14,2,0,16
23/09/2020,Waikato,0,0,0,0,155,39,2,194
23/09/2020,Wairarapa,0,0,0,0,6,2,0,8
23/09/2020,Waitemata,0,0,0,0,221,71,4,292
23/09/2020,West Coast,0,0,0,0,4,1,1,5
23/09/2020,Whanganui,0,0,0,0,8,1,0,9
22/09/2020,Auckland,3,0,0,3,222,51,1,273
22/09/2020,Bay of Plenty,0,0,0,0,34,14,0,48
22/09/2020,Canterbury,0,0,0,0,125,65,12,190
22/09/2020,Capital and Coast,0,0,0,0,73,24,2,97
22/09/2020,Counties Manukau,0,0,0,0,241,24,1,265
22/09/2020,Hawke's Bay,0,0,0,0,38,6,0,44
22/09/2020,Hutt Valley,0,0,0,0,19,3,0,22
22/09/2020,Lakes,0,0,0,0,15,1,0,16
22/09/2020,Midcentral,0,0,0,0,27,5,0,32
22/09/2020,Nelson Marlborough,0,0,0,0,37,12,0,49
22/09/2020,Northland,0,0,0,0,26,2,0,28
22/09/2020,South Canterbury,0,0,0,0,15,2,0,17
22/09/2020,Southern,0,0,0,0,186,30,2,216
22/09/2020,Tairawhiti,0,0,0,0,3,1,0,4
22/09/2020,Taranaki,0,0,0,0,14,2,0,16
22/09/2020,Waikato,0,0,0,0,155,39,2,194
22/09/2020,Wairarapa,0,0,0,0,6,2,0,8
22/09/2020,Waitemata,0,0,0,0,221,71,4,292
22/09/2020,West Coast,0,0,0,0,4,1,1,5
22/09/2020,Whanganui,0,0,0,0,8,1,0,9
21/09/2020,Auckland,0,0,0,0,219,51,1,270
21/09/2020,Bay of Plenty,0,0,0,0,34,14,0,48
21/09/2020,Canterbury,0,0,0,0,125,65,12,190
21/09/2020,Capital and Coast,0,0,0,0,73,24,2,97
21/09/2020,Counties Manukau,1,0,0,1,241,24,1,265
21/09/2020,Hawke's Bay,0,0,0,0,38,6,0,44
21/09/2020,Hutt Valley,0,0,0,0,19,3,0,22
21/09/2020,Lakes,0,0,0,0,15,1,0,16
21/09/2020,Midcentral,0,0,0,0,27,5,0,32
21/09/2020,Nelson Marlborough,0,0,0,0,37,12,0,49
21/09/2020,Northland,0,0,0,0,26,2,0,28
21/09/2020,South Canterbury,0,0,0,0,15,2,0,17
21/09/2020,Southern,0,0,0,0,186,30,2,216
21/09/2020,Tairawhiti,0,0,0,0,3,1,0,4
21/09/2020,Taranaki,0,0,0,0,14,2,0,16
21/09/2020,Waikato,0,0,0,0,155,39,2,194
21/09/2020,Wairarapa,0,0,0,0,6,2,0,8
21/09/2020,Waitemata,0,0,0,0,221,71,4,292
21/09/2020,West Coast,0,0,0,0,4,1,1,5
21/09/2020,Whanganui,0,0,0,0,8,1,0,9
20/09/2020,Auckland,0,0,0,0,219,51,1,270
20/09/2020,Bay of Plenty,0,0,0,0,34,14,0,48
20/09/2020,Canterbury,0,0,0,0,125,65,12,190
20/09/2020,Capital and Coast,0,0,0,0,73,24,2,97
20/09/2020,Counties Manukau,0,0,0,0,240,24,1,264
20/09/2020,Hawke's Bay,0,0,0,0,38,6,0,44
20/09/2020,Hutt Valley,0,0,0,0,19,3,0,22
20/09/2020,Lakes,0,0,0,0,15,1,0,16
20/09/2020,Midcentral,0,0,0,0,27,5,0,32
20/09/2020,Nelson Marlborough,0,0,0,0,37,12,0,49
20/09/2020,Northland,0,0,0,0,26,2,0,28
20/09/2020,South Canterbury,0,0,0,0,15,2,0,17
20/09/2020,Southern,0,0,0,0,186,30,2,216
20/09/2020,Tairawhiti,0,0,0,0,3,1,0,4
20/09/2020,Taranaki,0,0,0,0,14,2,0,16
20/09/2020,Waikato,0,0,0,0,155,39,2,194
20/09/2020,Wairarapa,0,0,0,0,6,2,0,8
20/09/2020,Waitemata,0,0,0,0,221,71,4,292
20/09/2020,West Coast,0,0,0,0,4,1,1,5
20/09/2020,Whanganui,0,0,0,0,8,1,0,9
19/09/2020,Auckland,1,0,0,1,219,51,1,270
19/09/2020,Bay of Plenty,0,0,0,0,34,14,0,48
19/09/2020,Canterbury,0,0,0,0,125,65,12,190
19/09/2020,Capital and Coast,0,0,0,0,73,24,2,97
19/09/2020,Counties Manukau,2,0,0,2,240,24,1,264
19/09/2020,Hawke's Bay,0,0,0,0,38,6,0,44
19/09/2020,Hutt Valley,0,0,0,0,19,3,0,22
19/09/2020,Lakes,0,0,0,0,15,1,0,16
19/09/2020,Midcentral,0,0,0,0,27,5,0,32
19/09/2020,Nelson Marlborough,0,0,0,0,37,12,0,49
19/09/2020,Northland,0,0,0,0,26,2,0,28
19/09/2020,South Canterbury,0,0,0,0,15,2,0,17
19/09/2020,Southern,0,0,0,0,186,30,2,216
19/09/2020,Tairawhiti,0,0,0,0,3,1,0,4
19/09/2020,Taranaki,0,0,0,0,14,2,0,16
19/09/2020,Waikato,0,0,0,0,155,39,2,194
19/09/2020,Wairarapa,0,0,0,0,6,2,0,8
19/09/2020,Waitemata,0,0,0,0,221,71,4,292
19/09/2020,West Coast,0,0,0,0,4,1,1,5
19/09/2020,Whanganui,0,0,0,0,8,1,0,9
18/09/2020,Auckland,2,0,0,2,218,51,1,269
18/09/2020,Bay of Plenty,0,0,0,0,34,14,0,48
18/09/2020,Canterbury,0,0,0,0,125,65,12,190
18/09/2020,Capital and Coast,0,0,0,0,73,24,2,97
18/09/2020,Counties Manukau,1,0,0,1,238,24,1,262
18/09/2020,Hawke's Bay,0,0,0,0,38,6,0,44
18/09/2020,Hutt Valley,0,0,0,0,19,3,0,22
18/09/2020,Lakes,0,0,0,0,15,1,0,16
18/09/2020,Midcentral,0,0,0,0,27,5,0,32
18/09/2020,Nelson Marlborough,0,0,0,0,37,12,0,49
18/09/2020,Northland,0,0,0,0,26,2,0,28
18/09/2020,South Canterbury,0,0,0,0,15,2,0,17
18/09/2020,Southern,0,0,0,0,186,30,2,216
18/09/2020,Tairawhiti,0,0,0,0,3,1,0,4
18/09/2020,Taranaki,0,0,0,0,14,2,0,16
18/09/2020,Waikato,0,0,0,0,155,39,2,194
18/09/2020,Wairarapa,0,0,0,0,6,2,0,8
18/09/2020,Waitemata,0,0,0,0,221,71,4,292
18/09/2020,West Coast,0,0,0,0,4,1,1,5
18/09/2020,Whanganui,0,0,0,0,8,1,0,9
17/09/2020,Auckland,0,0,0,0,216,51,1,267
17/09/2020,Bay of Plenty,0,0,0,0,34,14,0,48
17/09/2020,Canterbury,0,0,0,0,125,65,12,190
17/09/2020,Capital and Coast,0,0,0,0,73,24,2,97
17/09/2020,Counties Manukau,0,0,0,0,237,24,1,261
17/09/2020,Hawke's Bay,0,0,0,0,38,6,0,44
17/09/2020,Hutt Valley,0,0,0,0,19,3,0,22
17/09/2020,Lakes,0,0,0,0,15,1,0,16
17/09/2020,Midcentral,0,0,0,0,27,5,0,32
17/09/2020,Nelson Marlborough,0,0,0,0,37,12,0,49
17/09/2020,Northland,0,0,0,0,26,2,0,28
17/09/2020,South Canterbury,0,0,0,0,15,2,0,17
17/09/2020,Southern,0,0,0,0,186,30,2,216
17/09/2020,Tairawhiti,0,0,0,0,3,1,0,4
17/09/2020,Taranaki,0,0,0,0,14,2,0,16
17/09/2020,Waikato,0,0,0,0,155,39,2,194
17/09/2020,Wairarapa,0,0,0,0,6,2,0,8
17/09/2020,Waitemata,0,0,0,0,221,71,4,292
17/09/2020,West Coast,0,0,0,0,4,1,1,5
17/09/2020,Whanganui,0,0,0,0,8,1,0,9
16/09/2020,Auckland,4,0,0,4,216,51,1,267
16/09/2020,Bay of Plenty,0,0,0,0,34,14,0,48
16/09/2020,Canterbury,1,0,0,1,125,65,12,190
16/09/2020,Capital and Coast,1,0,0,1,73,24,2,97
16/09/2020,Counties Manukau,1,0,0,1,237,24,1,261
16/09/2020,Hawke's Bay,0,0,0,0,38,6,0,44
16/09/2020,Hutt Valley,0,0,0,0,19,3,0,22
16/09/2020,Lakes,0,0,0,0,15,1,0,16
16/09/2020,Midcentral,0,0,0,0,27,5,0,32
16/09/2020,Nelson Marlborough,0,0,0,0,37,12,0,49
16/09/2020,Northland,0,0,0,0,26,2,0,28
16/09/2020,South Canterbury,0,0,0,0,15,2,0,17
16/09/2020,Southern,0,0,0,0,186,30,2,216
16/09/2020,Tairawhiti,0,0,0,0,3,1,0,4
16/09/2020,Taranaki,0,0,0,0,14,2,0,16
16/09/2020,Waikato,0,5,0,5,155,39,2,194
16/09/2020,Wairarapa,0,0,0,0,6,2,0,8
16/09/2020,Waitemata,0,0,0,0,221,71,4,292
16/09/2020,West Coast,0,0,0,0,4,1,1,5
16/09/2020,Whanganui,0,0,0,0,8,1,0,9
15/09/2020,Auckland,0,0,0,0,212,51,1,263
15/09/2020,Bay of Plenty,0,0,0,0,34,14,0,48
15/09/2020,Canterbury,0,0,0,0,124,65,12,189
15/09/2020,Capital and Coast,0,0,0,0,72,24,2,96
15/09/2020,Counties Manukau,0,0,0,0,236,24,1,260
15/09/2020,Hawke's Bay,0,0,0,0,38,6,0,44
15/09/2020,Hutt Valley,0,0,0,0,19,3,0,22
15/09/2020,Lakes,0,0,0,0,15,1,0,16
15/09/2020,Midcentral,0,0,0,0,27,5,0,32
15/09/2020,Nelson Marlborough,0,0,0,0,37,12,0,49
15/09/2020,Northland,0,0,0,0,26,2,0,28
15/09/2020,South Canterbury,0,0,0,0,15,2,0,17
15/09/2020,Southern,0,0,0,0,186,30,2,216
15/09/2020,Tairawhiti,0,0,0,0,3,1,0,4
15/09/2020,Taranaki,0,0,0,0,14,2,0,16
15/09/2020,Waikato,0,0,1,0,155,34,2,189
15/09/2020,Wairarapa,0,0,0,0,6,2,0,8
15/09/2020,Waitemata,0,0,0,0,221,71,4,292
15/09/2020,West Coast,0,0,0,0,4,1,1,5
15/09/2020,Whanganui,0,0,0,0,8,1,0,9
14/09/2020,Auckland,0,0,0,0,212,51,1,263
14/09/2020,Bay of Plenty,0,0,0,0,34,14,0,48
14/09/2020,Canterbury,0,0,0,0,124,65,12,189
14/09/2020,Capital and Coast,0,0,0,0,72,24,2,96
14/09/2020,Counties Manukau,4,0,0,4,236,24,1,260
14/09/2020,Hawke's Bay,0,0,0,0,38,6,0,44
14/09/2020,Hutt Valley,0,0,0,0,19,3,0,22
14/09/2020,Lakes,0,0,0,0,15,1,0,16
14/09/2020,Midcentral,0,0,0,0,27,5,0,32
14/09/2020,Nelson Marlborough,0,0,0,0,37,12,0,49
14/09/2020,Northland,0,0,0,0,26,2,0,28
14/09/2020,South Canterbury,0,0,0,0,15,2,0,17
14/09/2020,Southern,0,0,0,0,186,30,2,216
14/09/2020,Tairawhiti,0,0,0,0,3,1,0,4
14/09/2020,Taranaki,0,0,0,0,14,2,0,16
14/09/2020,Waikato,1,0,0,1,155,34,1,189
14/09/2020,Wairarapa,0,0,0,0,6,2,0,8
14/09/2020,Waitemata,0,0,0,0,221,71,4,292
14/09/2020,West Coast,0,0,0,0,4,1,1,5
14/09/2020,Whanganui,0,0,0,0,8,1,0,9
13/09/2020,Auckland,0,0,0,0,212,51,1,263
13/09/2020,Bay of Plenty,0,0,0,0,34,14,0,48
13/09/2020,Canterbury,0,0,0,0,124,65,12,189
13/09/2020,Capital and Coast,0,0,0,0,72,24,2,96
13/09/2020,Counties Manukau,1,0,0,1,232,24,1,256
13/09/2020,Hawke's Bay,0,0,0,0,38,6,0,44
13/09/2020,Hutt Valley,0,0,0,0,19,3,0,22
13/09/2020,Lakes,0,0,0,0,15,1,0,16
13/09/2020,Midcentral,0,0,0,0,27,5,0,32
13/09/2020,Nelson Marlborough,0,0,0,0,37,12,0,49
13/09/2020,Northland,0,0,0,0,26,2,0,28
13/09/2020,South Canterbury,0,0,0,0,15,2,0,17
13/09/2020,Southern,0,0,0,0,186,30,2,216
13/09/2020,Tairawhiti,0,0,0,0,3,1,0,4
13/09/2020,Taranaki,0,0,0,0,14,2,0,16
13/09/2020,Waikato,0,0,0,0,154,34,1,188
13/09/2020,Wairarapa,0,0,0,0,6,2,0,8
13/09/2020,Waitemata,0,0,0,0,221,71,4,292
13/09/2020,West Coast,0,0,0,0,4,1,1,5
13/09/2020,Whanganui,0,0,0,0,8,1,0,9
12/09/2020,Auckland,0,0,0,0,212,51,1,263
12/09/2020,Bay of Plenty,0,0,0,0,34,14,0,48
12/09/2020,Canterbury,1,0,0,1,124,65,12,189
12/09/2020,Capital and Coast,0,0,0,0,72,24,2,96
12/09/2020,Counties Manukau,0,0,0,0,231,24,1,255
12/09/2020,Hawke's Bay,0,0,0,0,38,6,0,44
12/09/2020,Hutt Valley,0,0,0,0,19,3,0,22
12/09/2020,Lakes,0,0,0,0,15,1,0,16
12/09/2020,Midcentral,0,0,0,0,27,5,0,32
12/09/2020,Nelson Marlborough,0,0,0,0,37,12,0,49
12/09/2020,Northland,0,0,0,0,26,2,0,28
12/09/2020,South Canterbury,0,0,0,0,15,2,0,17
12/09/2020,Southern,0,0,0,0,186,30,2,216
12/09/2020,Tairawhiti,0,0,0,0,3,1,0,4
12/09/2020,Taranaki,0,0,0,0,14,2,0,16
12/09/2020,Waikato,0,0,0,0,154,34,1,188
12/09/2020,Wairarapa,0,0,0,0,6,2,0,8
12/09/2020,Waitemata,1,0,0,1,221,71,4,292
12/09/2020,West Coast,0,0,0,0,4,1,1,5
12/09/2020,Whanganui,0,0,0,0,8,1,0,9
11/09/2020,Auckland,0,0,0,0,212,51,1,263
11/09/2020,Bay of Plenty,0,0,0,0,34,14,0,48
11/09/2020,Canterbury,0,0,0,0,123,65,12,188
11/09/2020,Capital and Coast,0,0,0,0,72,24,2,96
11/09/2020,Counties Manukau,0,0,0,0,231,24,1,255
11/09/2020,Hawke's Bay,0,0,0,0,38,6,0,44
11/09/2020,Hutt Valley,0,0,0,0,19,3,0,22
11/09/2020,Lakes,0,0,0,0,15,1,0,16
11/09/2020,Midcentral,0,0,0,0,27,5,0,32
11/09/2020,Nelson Marlborough,0,0,0,0,37,12,0,49
11/09/2020,Northland,0,0,0,0,26,2,0,28
11/09/2020,South Canterbury,0,0,0,0,15,2,0,17
11/09/2020,Southern,0,0,0,0,186,30,2,216
11/09/2020,Tairawhiti,0,0,0,0,3,1,0,4
11/09/2020,Taranaki,0,0,0,0,14,2,0,16
11/09/2020,Waikato,0,0,0,0,154,34,1,188
11/09/2020,Wairarapa,0,0,0,0,6,2,0,8
11/09/2020,Waitemata,2,0,0,2,220,71,4,291
11/09/2020,West Coast,0,0,0,0,4,1,1,5
11/09/2020,Whanganui,0,0,0,0,8,1,0,9
10/09/2020,Auckland,1,0,0,1,212,51,1,263
10/09/2020,Bay of Plenty,0,0,0,0,34,14,0,48
10/09/2020,Canterbury,0,0,0,0,123,65,12,188
10/09/2020,Capital and Coast,0,0,0,0,72,24,2,96
10/09/2020,Counties Manukau,1,0,0,1,231,24,1,255
10/09/2020,Hawke's Bay,0,0,0,0,38,6,0,44
10/09/2020,Hutt Valley,0,0,0,0,19,3,0,22
10/09/2020,Lakes,0,0,0,0,15,1,0,16
10/09/2020,Midcentral,0,0,0,0,27,5,0,32
10/09/2020,Nelson Marlborough,0,0,0,0,37,12,0,49
10/09/2020,Northland,0,0,0,0,26,2,0,28
10/09/2020,South Canterbury,0,0,0,0,15,2,0,17
10/09/2020,Southern,0,0,0,0,186,30,2,216
10/09/2020,Tairawhiti,0,0,0,0,3,1,0,4
10/09/2020,Taranaki,0,0,0,0,14,2,0,16
10/09/2020,Waikato,0,0,0,0,154,34,1,188
10/09/2020,Wairarapa,0,0,0,0,6,2,0,8
10/09/2020,Waitemata,0,0,0,0,218,71,4,289
10/09/2020,West Coast,0,0,0,0,4,1,1,5
10/09/2020,Whanganui,0,0,0,0,8,1,0,9
09/09/2020,Auckland,0,0,0,0,211,51,1,262
09/09/2020,Bay of Plenty,0,0,0,0,34,14,0,48
09/09/2020,Canterbury,2,0,0,2,123,65,12,188
09/09/2020,Capital and Coast,0,0,0,0,72,24,2,96
09/09/2020,Counties Manukau,0,0,0,0,230,24,1,254
09/09/2020,Hawke's Bay,0,0,0,0,38,6,0,44
09/09/2020,Hutt Valley,0,0,0,0,19,3,0,22
09/09/2020,Lakes,0,0,0,0,15,1,0,16
09/09/2020,Midcentral,0,0,0,0,27,5,0,32
09/09/2020,Nelson Marlborough,0,0,0,0,37,12,0,49
09/09/2020,Northland,0,0,0,0,26,2,0,28
09/09/2020,South Canterbury,0,0,0,0,15,2,0,17
09/09/2020,Southern,0,0,0,0,186,30,2,216
09/09/2020,Tairawhiti,0,0,0,0,3,1,0,4
09/09/2020,Taranaki,0,0,0,0,14,2,0,16
09/09/2020,Waikato,0,0,0,0,154,34,1,188
09/09/2020,Wairarapa,0,0,0,0,6,2,0,8
09/09/2020,Waitemata,1,0,0,1,218,71,4,289
09/09/2020,West Coast,0,0,0,0,4,1,1,5
09/09/2020,Whanganui,0,0,0,0,8,1,0,9
08/09/2020,Auckland,2,0,0,2,211,51,1,262
08/09/2020,Bay of Plenty,0,0,0,0,34,14,0,48
08/09/2020,Canterbury,0,0,0,0,121,65,12,186
08/09/2020,Capital and Coast,0,0,0,0,72,24,2,96
08/09/2020,Counties Manukau,1,0,0,1,230,24,1,254
08/09/2020,Hawke's Bay,0,0,0,0,38,6,0,44
08/09/2020,Hutt Valley,0,0,0,0,19,3,0,22
08/09/2020,Lakes,0,0,0,0,15,1,0,16
08/09/2020,Midcentral,0,0,0,0,27,5,0,32
08/09/2020,Nelson Marlborough,0,0,0,0,37,12,0,49
08/09/2020,Northland,0,0,0,0,26,2,0,28
08/09/2020,South Canterbury,0,0,0,0,15,2,0,17
08/09/2020,Southern,0,0,0,0,186,30,2,216
08/09/2020,Tairawhiti,0,0,0,0,3,1,0,4
08/09/2020,Taranaki,0,0,0,0,14,2,0,16
08/09/2020,Waikato,0,0,0,0,154,34,1,188
08/09/2020,Wairarapa,0,0,0,0,6,2,0,8
08/09/2020,Waitemata,3,0,0,3,217,71,4,288
08/09/2020,West Coast,0,0,0,0,4,1,1,5
08/09/2020,Whanganui,0,0,0,0,8,1,0,9
07/09/2020,Auckland,0,0,0,0,209,51,1,260
07/09/2020,Bay of Plenty,0,0,0,0,34,14,0,48
07/09/2020,Canterbury,0,0,0,0,121,65,12,186
07/09/2020,Capital and Coast,0,0,0,0,72,24,2,96
07/09/2020,Counties Manukau,2,0,0,2,229,24,1,253
07/09/2020,Hawke's Bay,0,0,0,0,38,6,0,44
07/09/2020,Hutt Valley,0,0,0,0,19,3,0,22
07/09/2020,Lakes,0,0,0,0,15,1,0,16
07/09/2020,Midcentral,0,0,0,0,27,5,0,32
07/09/2020,Nelson Marlborough,0,0,0,0,37,12,0,49
07/09/2020,Northland,0,0,0,0,26,2,0,28
07/09/2020,South Canterbury,0,0,0,0,15,2,0,17
07/09/2020,Southern,0,0,0,0,186,30,2,216
07/09/2020,Tairawhiti,0,0,0,0,3,1,0,4
07/09/2020,Taranaki,0,0,0,0,14,2,0,16
07/09/2020,Waikato,0,0,0,0,154,34,1,188
07/09/2020,Wairarapa,0,0,0,0,6,2,0,8
07/09/2020,Waitemata,4,0,0,4,214,71,4,285
07/09/2020,West Coast,0,0,0,0,4,1,1,5
07/09/2020,Whanganui,0,0,0,0,8,1,0,9
06/09/2020,Auckland,0,0,0,0,209,51,1,260
06/09/2020,Bay of Plenty,0,0,0,0,34,14,0,48
06/09/2020,Canterbury,0,0,0,0,121,65,12,186
06/09/2020,Capital and Coast,0,0,0,0,72,24,2,96
06/09/2020,Counties Manukau,1,0,0,1,227,24,1,251
06/09/2020,Hawke's Bay,0,0,0,0,38,6,0,44
06/09/2020,Hutt Valley,0,0,0,0,19,3,0,22
06/09/2020,Lakes,0,0,0,0,15,1,0,16
06/09/2020,Midcentral,0,0,0,0,27,5,0,32
06/09/2020,Nelson Marlborough,0,0,0,0,37,12,0,49
06/09/2020,Northland,0,0,0,0,26,2,0,28
06/09/2020,South Canterbury,0,0,0,0,15,2,0,17
06/09/2020,Southern,0,0,0,0,186,30,2,216
06/09/2020,Tairawhiti,0,0,0,0,3,1,0,4
06/09/2020,Taranaki,0,0,0,0,14,2,0,16
06/09/2020,Waikato,0,0,0,0,154,34,1,188
06/09/2020,Wairarapa,0,0,0,0,6,2,0,8
06/09/2020,Waitemata,2,0,0,2,210,71,4,281
06/09/2020,West Coast,0,0,0,0,4,1,1,5
06/09/2020,Whanganui,0,0,0,0,8,1,0,9
05/09/2020,Auckland,2,0,1,2,209,51,1,260
05/09/2020,Bay of Plenty,0,0,0,0,34,14,0,48
05/09/2020,Canterbury,0,0,0,0,121,65,12,186
05/09/2020,Capital and Coast,0,0,0,0,72,24,2,96
05/09/2020,Counties Manukau,0,0,0,0,226,24,1,250
05/09/2020,Hawke's Bay,0,0,0,0,38,6,0,44
05/09/2020,Hutt Valley,0,0,0,0,19,3,0,22
05/09/2020,Lakes,0,0,0,0,15,1,0,16
05/09/2020,Midcentral,0,0,0,0,27,5,0,32
05/09/2020,Nelson Marlborough,0,0,0,0,37,12,0,49
05/09/2020,Northland,0,0,0,0,26,2,0,28
05/09/2020,South Canterbury,0,0,0,0,15,2,0,17
05/09/2020,Southern,0,0,0,0,186,30,2,216
05/09/2020,Tairawhiti,0,0,0,0,3,1,0,4
05/09/2020,Taranaki,0,0,0,0,14,2,0,16
05/09/2020,Waikato,0,0,0,0,154,34,1,188
05/09/2020,Wairarapa,0,0,0,0,6,2,0,8
05/09/2020,Waitemata,5,0,0,5,208,71,4,279
05/09/2020,West Coast,0,0,0,0,4,1,1,5
05/09/2020,Whanganui,0,0,0,0,8,1,0,9
04/09/2020,Auckland,1,0,0,1,207,51,0,258
04/09/2020,Bay of Plenty,0,0,0,0,34,14,0,48
04/09/2020,Canterbury,0,0,0,0,121,65,12,186
04/09/2020,Capital and Coast,0,0,0,0,72,24,2,96
04/09/2020,Counties Manukau,2,0,1,2,226,24,1,250
04/09/2020,Hawke's Bay,0,0,0,0,38,6,0,44
04/09/2020,Hutt Valley,0,0,0,0,19,3,0,22
04/09/2020,Lakes,0,0,0,0,15,1,0,16
04/09/2020,Midcentral,0,0,0,0,27,5,0,32
04/09/2020,Nelson Marlborough,0,0,0,0,37,12,0,49
04/09/2020,Northland,0,0,0,0,26,2,0,28
04/09/2020,South Canterbury,0,0,0,0,15,2,0,17
04/09/2020,Southern,0,0,0,0,186,30,2,216
04/09/2020,Tairawhiti,0,0,0,0,3,1,0,4
04/09/2020,Taranaki,0,0,0,0,14,2,0,16
04/09/2020,Waikato,0,0,0,0,154,34,1,188
04/09/2020,Wairarapa,0,0,0,0,6,2,0,8
04/09/2020,Waitemata,1,0,0,1,203,71,4,274
04/09/2020,West Coast,0,0,0,0,4,1,1,5
04/09/2020,Whanganui,0,0,0,0,8,1,0,9
03/09/2020,Auckland,0,0,0,0,206,51,0,257
03/09/2020,Bay of Plenty,0,0,0,0,34,14,0,48
03/09/2020,Canterbury,0,0,0,0,121,65,12,186
03/09/2020,Capital and Coast,0,0,0,0,72,24,2,96
03/09/2020,Counties Manukau,3,0,0,3,224,24,0,248
03/09/2020,Hawke's Bay,0,0,0,0,38,6,0,44
03/09/2020,Hutt Valley,0,0,0,0,19,3,0,22
03/09/2020,Lakes,0,0,0,0,15,1,0,16
03/09/2020,Midcentral,0,0,0,0,27,5,0,32
03/09/2020,Nelson Marlborough,0,0,0,0,37,12,0,49
03/09/2020,Northland,0,0,0,0,26,2,0,28
03/09/2020,South Canterbury,0,0,0,0,15,2,0,17
03/09/2020,Southern,0,0,0,0,186,30,2,216
03/09/2020,Tairawhiti,0,0,0,0,3,1,0,4
03/09/2020,Taranaki,0,0,0,0,14,2,0,16
03/09/2020,Waikato,0,0,0,0,154,34,1,188
03/09/2020,Wairarapa,0,0,0,0,6,2,0,8
03/09/2020,Waitemata,0,0,0,0,202,71,4,273
03/09/2020,West Coast,0,0,0,0,4,1,1,5
03/09/2020,Whanganui,0,0,0,0,8,1,0,9
02/09/2020,Auckland,2,0,0,2,206,51,0,257
02/09/2020,Bay of Plenty,0,0,0,0,34,14,0,48
02/09/2020,Canterbury,1,0,0,1,121,65,12,186
02/09/2020,Capital and Coast,0,0,0,0,72,24,2,96
02/09/2020,Counties Manukau,1,0,0,1,221,24,0,245
02/09/2020,Hawke's Bay,0,0,0,0,38,6,0,44
02/09/2020,Hutt Valley,0,0,0,0,19,3,0,22
02/09/2020,Lakes,0,0,0,0,15,1,0,16
02/09/2020,Midcentral,0,0,0,0,27,5,0,32
02/09/2020,Nelson Marlborough,0,0,0,0,37,12,0,49
02/09/2020,Northland,0,0,0,0,26,2,0,28
02/09/2020,South Canterbury,0,0,0,0,15,2,0,17
02/09/2020,Southern,0,0,0,0,186,30,2,216
02/09/2020,Tairawhiti,0,0,0,0,3,1,0,4
02/09/2020,Taranaki,0,0,0,0,14,2,0,16
02/09/2020,Waikato,0,0,0,0,154,34,1,188
02/09/2020,Wairarapa,0,0,0,0,6,2,0,8
02/09/2020,Waitemata,1,0,0,1,202,71,4,273
02/09/2020,West Coast,0,0,0,0,4,1,1,5
02/09/2020,Whanganui,0,0,0,0,8,1,0,9
01/09/2020,Auckland,0,0,0,0,204,51,0,255
01/09/2020,Bay of Plenty,0,0,0,0,34,14,0,48
01/09/2020,Canterbury,0,0,0,0,120,65,12,185
01/09/2020,Capital and Coast,0,0,0,0,72,24,2,96
01/09/2020,Counties Manukau,6,0,0,6,220,24,0,244
01/09/2020,Hawke's Bay,0,0,0,0,38,6,0,44
01/09/2020,Hutt Valley,0,0,0,0,19,3,0,22
01/09/2020,Lakes,0,0,0,0,15,1,0,16
01/09/2020,Midcentral,0,0,0,0,27,5,0,32
01/09/2020,Nelson Marlborough,0,0,0,0,37,12,0,49
01/09/2020,Northland,0,0,0,0,26,2,0,28
01/09/2020,South Canterbury,0,0,0,0,15,2,0,17
01/09/2020,Southern,0,0,0,0,186,30,2,216
01/09/2020,Tairawhiti,0,0,0,0,3,1,0,4
01/09/2020,Taranaki,0,0,0,0,14,2,0,16
01/09/2020,Waikato,0,0,0,0,154,34,1,188
01/09/2020,Wairarapa,0,0,0,0,6,2,0,8
01/09/2020,Waitemata,0,0,0,0,201,71,4,272
01/09/2020,West Coast,0,0,0,0,4,1,1,5
01/09/2020,Whanganui,0,0,0,0,8,1,0,9
31/08/2020,Auckland,0,0,0,0,204,51,0,255
31/08/2020,Bay of Plenty,0,0,0,0,34,14,0,48
31/08/2020,Canterbury,5,0,0,5,120,65,12,185
31/08/2020,Capital and Coast,1,0,0,1,72,24,2,96
31/08/2020,Counties Manukau,7,0,0,7,214,24,0,238
31/08/2020,Hawke's Bay,0,0,0,0,38,6,0,44
31/08/2020,Hutt Valley,0,0,0,0,19,3,0,22
31/08/2020,Lakes,0,0,0,0,15,1,0,16
31/08/2020,Midcentral,0,0,0,0,27,5,0,32
31/08/2020,Nelson Marlborough,0,0,0,0,37,12,0,49
31/08/2020,Northland,0,0,0,0,26,2,0,28
31/08/2020,South Canterbury,0,0,0,0,15,2,0,17
31/08/2020,Southern,0,0,0,0,186,30,2,216
31/08/2020,Tairawhiti,0,0,0,0,3,1,0,4
31/08/2020,Taranaki,0,0,0,0,14,2,0,16
31/08/2020,Waikato,0,0,0,0,154,34,1,188
31/08/2020,Wairarapa,0,0,0,0,6,2,0,8
31/08/2020,Waitemata,1,0,0,1,201,71,4,272
31/08/2020,West Coast,0,0,0,0,4,1,1,5
31/08/2020,Whanganui,0,0,0,0,8,1,0,9
30/08/2020,Auckland,3,0,0,3,204,51,0,255
30/08/2020,Bay of Plenty,0,0,0,0,34,14,0,48
30/08/2020,Canterbury,1,0,0,1,115,65,12,180
30/08/2020,Capital and Coast,0,0,0,0,71,24,2,95
30/08/2020,Counties Manukau,1,0,0,1,207,24,0,231
30/08/2020,Hawke's Bay,0,0,0,0,38,6,0,44
30/08/2020,Hutt Valley,0,0,0,0,19,3,0,22
30/08/2020,Lakes,0,0,0,0,15,1,0,16
30/08/2020,Midcentral,0,0,0,0,27,5,0,32
30/08/2020,Nelson Marlborough,0,0,0,0,37,12,0,49
30/08/2020,Northland,0,0,0,0,26,2,0,28
30/08/2020,South Canterbury,0,0,0,0,15,2,0,17
30/08/2020,Southern,0,0,0,0,186,30,2,216
30/08/2020,Tairawhiti,0,0,0,0,3,1,0,4
30/08/2020,Taranaki,0,0,0,0,14,2,0,16
30/08/2020,Waikato,0,0,0,0,154,34,1,188
30/08/2020,Wairarapa,0,0,0,0,6,2,0,8
30/08/2020,Waitemata,0,0,0,0,200,71,4,271
30/08/2020,West Coast,0,0,0,0,4,1,1,5
30/08/2020,Whanganui,0,0,0,0,8,1,0,9
29/08/2020,Auckland,1,0,0,1,201,51,0,252
29/08/2020,Bay of Plenty,0,0,0,0,34,14,0,48
29/08/2020,Canterbury,0,0,0,0,114,65,12,179
29/08/2020,Capital and Coast,0,0,0,0,71,24,2,95
29/08/2020,Counties Manukau,2,0,0,2,206,24,0,230
29/08/2020,Hawke's Bay,0,0,0,0,38,6,0,44
29/08/2020,Hutt Valley,0,0,0,0,19,3,0,22
29/08/2020,Lakes,0,0,0,0,15,1,0,16
29/08/2020,Midcentral,0,0,0,0,27,5,0,32
29/08/2020,Nelson Marlborough,0,0,0,0,37,12,0,49
29/08/2020,Northland,0,0,0,0,26,2,0,28
29/08/2020,South Canterbury,0,0,0,0,15,2,0,17
29/08/2020,Southern,0,0,0,0,186,30,2,216
29/08/2020,Tairawhiti,0,0,0,0,3,1,0,4
29/08/2020,Taranaki,0,0,0,0,14,2,0,16
29/08/2020,Waikato,0,0,0,0,154,34,1,188
29/08/2020,Wairarapa,0,0,0,0,6,2,0,8
29/08/2020,Waitemata,1,0,0,1,200,71,4,271
29/08/2020,West Coast,0,0,0,0,4,1,1,5
29/08/2020,Whanganui,0,0,0,0,8,1,0,9
28/08/2020,Auckland,10,0,0,10,200,51,0,251
28/08/2020,Bay of Plenty,0,0,0,0,34,14,0,48
28/08/2020,Canterbury,0,0,0,0,114,65,12,179
28/08/2020,Capital and Coast,0,0,0,0,71,24,2,95
28/08/2020,Counties Manukau,5,0,0,5,204,24,0,228
28/08/2020,Hawke's Bay,0,0,0,0,38,6,0,44
28/08/2020,Hutt Valley,0,0,0,0,19,3,0,22
28/08/2020,Lakes,0,0,0,0,15,1,0,16
28/08/2020,Midcentral,0,0,0,0,27,5,0,32
28/08/2020,Nelson Marlborough,0,0,0,0,37,12,0,49
28/08/2020,Northland,0,0,0,0,26,2,0,28
28/08/2020,South Canterbury,0,0,0,0,15,2,0,17
28/08/2020,Southern,0,0,0,0,186,30,2,216
28/08/2020,Tairawhiti,0,0,0,0,3,1,0,4
28/08/2020,Taranaki,0,0,0,0,14,2,0,16
28/08/2020,Waikato,0,0,0,0,154,34,1,188
28/08/2020,Wairarapa,0,0,0,0,6,2,0,8
28/08/2020,Waitemata,3,0,0,3,199,71,4,270
28/08/2020,West Coast,0,0,0,0,4,1,1,5
28/08/2020,Whanganui,0,0,0,0,8,1,0,9
27/08/2020,Auckland,0,0,0,0,190,51,0,241
27/08/2020,Bay of Plenty,0,0,0,0,34,14,0,48
27/08/2020,Canterbury,0,0,0,0,114,65,12,179
27/08/2020,Capital and Coast,0,0,0,0,71,24,2,95
27/08/2020,Counties Manukau,1,0,0,1,199,24,0,223
27/08/2020,Hawke's Bay,0,0,0,0,38,6,0,44
27/08/2020,Hutt Valley,0,0,0,0,19,3,0,22
27/08/2020,Lakes,0,0,0,0,15,1,0,16
27/08/2020,Midcentral,0,0,0,0,27,5,0,32
27/08/2020,Nelson Marlborough,0,0,0,0,37,12,0,49
27/08/2020,Northland,0,0,0,0,26,2,0,28
27/08/2020,South Canterbury,0,0,0,0,15,2,0,17
27/08/2020,Southern,0,0,0,0,186,30,2,216
27/08/2020,Tairawhiti,0,0,0,0,3,1,0,4
27/08/2020,Taranaki,0,0,0,0,14,2,0,16
27/08/2020,Waikato,0,0,0,0,154,34,1,188
27/08/2020,Wairarapa,0,0,0,0,6,2,0,8
27/08/2020,Waitemata,5,0,0,5,196,71,4,267
27/08/2020,West Coast,0,0,0,0,4,1,1,5
27/08/2020,Whanganui,0,0,0,0,8,1,0,9
26/08/2020,Auckland,3,0,0,3,190,51,0,241
26/08/2020,Bay of Plenty,0,0,0,0,34,14,0,48
26/08/2020,Canterbury,0,0,0,0,114,65,12,179
26/08/2020,Capital and Coast,0,0,0,0,71,24,2,95
26/08/2020,Counties Manukau,0,0,0,0,198,24,0,222
26/08/2020,Hawke's Bay,0,0,0,0,38,6,0,44
26/08/2020,Hutt Valley,0,0,0,0,19,3,0,22
26/08/2020,Lakes,0,0,0,0,15,1,0,16
26/08/2020,Midcentral,0,0,0,0,27,5,0,32
26/08/2020,Nelson Marlborough,0,0,0,0,37,12,0,49
26/08/2020,Northland,0,0,0,0,26,2,0,28
26/08/2020,South Canterbury,0,0,0,0,15,2,0,17
26/08/2020,Southern,0,0,0,0,186,30,2,216
26/08/2020,Tairawhiti,0,0,0,0,3,1,0,4
26/08/2020,Taranaki,0,0,0,0,14,2,0,16
26/08/2020,Waikato,0,0,0,0,154,34,1,188
26/08/2020,Wairarapa,0,0,0,0,6,2,0,8
26/08/2020,Waitemata,4,0,0,4,191,71,4,262
26/08/2020,West Coast,0,0,0,0,4,1,1,5
26/08/2020,Whanganui,0,0,0,0,8,1,0,9
25/08/2020,Auckland,0,0,0,0,187,51,0,238
25/08/2020,Bay of Plenty,0,0,0,0,34,14,0,48
25/08/2020,Canterbury,1,0,0,1,114,65,12,179
25/08/2020,Capital and Coast,0,0,0,0,71,24,2,95
25/08/2020,Counties Manukau,1,0,0,1,198,24,0,222
25/08/2020,Hawke's Bay,0,0,0,0,38,6,0,44
25/08/2020,Hutt Valley,0,0,0,0,19,3,0,22
25/08/2020,Lakes,0,0,0,0,15,1,0,16
25/08/2020,Midcentral,0,0,0,0,27,5,0,32
25/08/2020,Nelson Marlborough,0,0,0,0,37,12,0,49
25/08/2020,Northland,0,0,0,0,26,2,0,28
25/08/2020,South Canterbury,0,0,0,0,15,2,0,17
25/08/2020,Southern,0,0,0,0,186,30,2,216
25/08/2020,Tairawhiti,0,0,0,0,3,1,0,4
25/08/2020,Taranaki,0,0,0,0,14,2,0,16
25/08/2020,Waikato,0,0,0,0,154,34,1,188
25/08/2020,Wairarapa,0,0,0,0,6,2,0,8
25/08/2020,Waitemata,2,0,0,2,187,71,4,258
25/08/2020,West Coast,0,0,0,0,4,1,1,5
25/08/2020,Whanganui,0,0,0,0,8,1,0,9
24/08/2020,Auckland,3,0,0,3,187,51,0,238
24/08/2020,Bay of Plenty,0,0,0,0,34,14,0,48
24/08/2020,Canterbury,0,0,0,0,113,65,12,178
24/08/2020,Capital and Coast,0,0,0,0,71,24,2,95
24/08/2020,Counties Manukau,2,0,0,2,197,24,0,221
24/08/2020,Hawke's Bay,0,0,0,0,38,6,0,44
24/08/2020,Hutt Valley,0,0,0,0,19,3,0,22
24/08/2020,Lakes,0,0,0,0,15,1,0,16
24/08/2020,Midcentral,0,0,0,0,27,5,0,32
24/08/2020,Nelson Marlborough,0,0,0,0,37,12,0,49
24/08/2020,Northland,0,0,0,0,26,2,0,28
24/08/2020,South Canterbury,0,0,0,0,15,2,0,17
24/08/2020,Southern,0,0,0,0,186,30,2,216
24/08/2020,Tairawhiti,0,0,0,0,3,1,0,4
24/08/2020,Taranaki,0,0,0,0,14,2,0,16
24/08/2020,Waikato,0,0,0,0,154,34,1,188
24/08/2020,Wairarapa,0,0,0,0,6,2,0,8
24/08/2020,Waitemata,2,0,0,2,185,71,4,256
24/08/2020,West Coast,0,0,0,0,4,1,1,5
24/08/2020,Whanganui,0,0,0,0,8,1,0,9
23/08/2020,Auckland,2,0,0,2,184,51,0,235
23/08/2020,Bay of Plenty,0,0,0,0,34,14,0,48
23/08/2020,Canterbury,0,0,0,0,113,65,12,178
23/08/2020,Capital and Coast,0,0,0,0,71,24,2,95
23/08/2020,Counties Manukau,5,0,0,5,195,24,0,219
23/08/2020,Hawke's Bay,0,0,0,0,38,6,0,44
23/08/2020,Hutt Valley,0,0,0,0,19,3,0,22
23/08/2020,Lakes,0,0,0,0,15,1,0,16
23/08/2020,Midcentral,0,0,0,0,27,5,0,32
23/08/2020,Nelson Marlborough,0,0,0,0,37,12,0,49
23/08/2020,Northland,0,0,0,0,26,2,0,28
23/08/2020,South Canterbury,0,0,0,0,15,2,0,17
23/08/2020,Southern,0,0,0,0,186,30,2,216
23/08/2020,Tairawhiti,0,0,0,0,3,1,0,4
23/08/2020,Taranaki,0,0,0,0,14,2,0,16
23/08/2020,Waikato,0,0,0,0,154,34,1,188
23/08/2020,Wairarapa,0,0,0,0,6,2,0,8
23/08/2020,Waitemata,1,0,0,1,183,71,4,254
23/08/2020,West Coast,0,0,0,0,4,1,1,5
23/08/2020,Whanganui,0,0,0,0,8,1,0,9
22/08/2020,Auckland,2,0,0,2,182,51,0,233
22/08/2020,Bay of Plenty,0,0,0,0,34,14,0,48
22/08/2020,Canterbury,0,0,0,0,113,65,12,178
22/08/2020,Capital and Coast,0,0,0,0,71,24,2,95
22/08/2020,Counties Manukau,1,0,0,1,190,24,0,214
22/08/2020,Hawke's Bay,0,0,0,0,38,6,0,44
22/08/2020,Hutt Valley,0,0,0,0,19,3,0,22
22/08/2020,Lakes,0,0,0,0,15,1,0,16
22/08/2020,Midcentral,0,0,0,0,27,5,0,32
22/08/2020,Nelson Marlborough,0,0,0,0,37,12,0,49
22/08/2020,Northland,0,0,0,0,26,2,0,28
22/08/2020,South Canterbury,0,0,0,0,15,2,0,17
22/08/2020,Southern,0,0,0,0,186,30,2,216
22/08/2020,Tairawhiti,0,0,0,0,3,1,0,4
22/08/2020,Taranaki,0,0,0,0,14,2,0,16
22/08/2020,Waikato,0,0,0,0,154,34,1,188
22/08/2020,Wairarapa,0,0,0,0,6,2,0,8
22/08/2020,Waitemata,1,0,0,1,182,71,4,253
22/08/2020,West Coast,0,0,0,0,4,1,1,5
22/08/2020,Whanganui,0,0,0,0,8,1,0,9
21/08/2020,Auckland,1,0,0,1,180,51,0,231
21/08/2020,Bay of Plenty,0,0,0,0,34,14,0,48
21/08/2020,Canterbury,0,0,0,0,113,65,12,178
21/08/2020,Capital and Coast,0,0,0,0,71,24,2,95
21/08/2020,Counties Manukau,4,1,0,5,189,24,0,213
21/08/2020,Hawke's Bay,0,0,0,0,38,6,0,44
21/08/2020,Hutt Valley,0,0,0,0,19,3,0,22
21/08/2020,Lakes,0,0,0,0,15,1,0,16
21/08/2020,Midcentral,0,0,0,0,27,5,0,32
21/08/2020,Nelson Marlborough,0,0,0,0,37,12,0,49
21/08/2020,Northland,0,0,0,0,26,2,0,28
21/08/2020,South Canterbury,0,0,0,0,15,2,0,17
21/08/2020,Southern,0,0,0,0,186,30,2,216
21/08/2020,Tairawhiti,0,0,0,0,3,1,0,4
21/08/2020,Taranaki,0,0,0,0,14,2,0,16
21/08/2020,Waikato,0,0,0,0,154,34,1,188
21/08/2020,Wairarapa,0,0,0,0,6,2,0,8
21/08/2020,Waitemata,1,0,0,1,181,71,4,252
21/08/2020,West Coast,0,0,0,0,4,1,1,5
21/08/2020,Whanganui,0,0,0,0,8,1,0,9
20/08/2020,Auckland,1,0,0,1,179,51,0,230
20/08/2020,Bay of Plenty,0,0,0,0,34,14,0,48
20/08/2020,Canterbury,0,0,0,0,113,65,12,178
20/08/2020,Capital and Coast,0,0,0,0,71,24,2,95
20/08/2020,Counties Manukau,5,0,0,5,185,23,0,208
20/08/2020,Hawke's Bay,0,0,0,0,38,6,0,44
20/08/2020,Hutt Valley,0,0,0,0,19,3,0,22
20/08/2020,Lakes,0,0,0,0,15,1,0,16
20/08/2020,Midcentral,0,0,0,0,27,5,0,32
20/08/2020,Nelson Marlborough,0,0,0,0,37,12,0,49
20/08/2020,Northland,0,0,0,0,26,2,0,28
20/08/2020,South Canterbury,0,0,0,0,15,2,0,17
20/08/2020,Southern,0,0,0,0,186,30,2,216
20/08/2020,Tairawhiti,0,0,0,0,3,1,0,4
20/08/2020,Taranaki,0,0,0,0,14,2,0,16
20/08/2020,Waikato,0,0,0,0,154,34,1,188
20/08/2020,Wairarapa,0,0,0,0,6,2,0,8
20/08/2020,Waitemata,1,0,0,1,180,71,4,251
20/08/2020,West Coast,0,0,0,0,4,1,1,5
20/08/2020,Whanganui,0,0,0,0,8,1,0,9
19/08/2020,Auckland,0,0,0,0,178,51,0,229
19/08/2020,Bay of Plenty,0,0,0,0,34,14,0,48
19/08/2020,Canterbury,0,0,0,0,113,65,12,178
19/08/2020,Capital and Coast,0,0,0,0,71,24,2,95
19/08/2020,Counties Manukau,1,0,0,1,180,23,0,203
19/08/2020,Hawke's Bay,0,0,0,0,38,6,0,44
19/08/2020,Hutt Valley,0,0,0,0,19,3,0,22
19/08/2020,Lakes,0,0,0,0,15,1,0,16
19/08/2020,Midcentral,0,0,0,0,27,5,0,32
19/08/2020,Nelson Marlborough,0,0,0,0,37,12,0,49
19/08/2020,Northland,0,0,0,0,26,2,0,28
19/08/2020,South Canterbury,0,0,0,0,15,2,0,17
19/08/2020,Southern,0,0,0,0,186,30,2,216
19/08/2020,Tairawhiti,0,0,0,0,3,1,0,4
19/08/2020,Taranaki,0,0,0,0,14,2,0,16
19/08/2020,Waikato,1,0,0,1,154,34,1,188
19/08/2020,Wairarapa,0,0,0,0,6,2,0,8
19/08/2020,Waitemata,3,0,0,3,179,71,4,250
19/08/2020,West Coast,0,0,0,0,4,1,1,5
19/08/2020,Whanganui,0,0,0,0,8,1,0,9
18/08/2020,Auckland,5,0,0,5,178,51,0,229
18/08/2020,Bay of Plenty,0,0,0,0,34,14,0,48
18/08/2020,Canterbury,0,0,0,0,113,65,12,178
18/08/2020,Capital and Coast,0,0,0,0,71,24,2,95
18/08/2020,Counties Manukau,5,0,0,5,179,23,0,202
18/08/2020,Hawke's Bay,0,0,0,0,38,6,0,44
18/08/2020,Hutt Valley,0,0,0,0,19,3,0,22
18/08/2020,Lakes,0,0,0,0,15,1,0,16
18/08/2020,Midcentral,0,0,0,0,27,5,0,32
18/08/2020,Nelson Marlborough,0,0,0,0,37,12,0,49
18/08/2020,Northland,0,0,0,0,26,2,0,28
18/08/2020,South Canterbury,0,0,0,0,15,2,0,17
18/08/2020,Southern,0,0,0,0,186,30,2,216
18/08/2020,Tairawhiti,0,0,0,0,3,1,0,4
18/08/2020,Taranaki,0,0,0,0,14,2,0,16
18/08/2020,Waikato,0,0,0,0,153,34,1,187
18/08/2020,Wairarapa,0,0,0,0,6,2,0,8
18/08/2020,Waitemata,1,0,0,1,176,71,4,247
18/08/2020,West Coast,0,0,0,0,4,1,1,5
18/08/2020,Whanganui,0,0,0,0,8,1,0,9
17/08/2020,Auckland,4,0,0,4,173,51,0,224
17/08/2020,Bay of Plenty,0,0,0,0,34,14,0,48
17/08/2020,Canterbury,0,0,0,0,113,65,12,178
17/08/2020,Capital and Coast,0,0,0,0,71,24,2,95
17/08/2020,Counties Manukau,5,0,0,5,174,23,0,197
17/08/2020,Hawke's Bay,0,0,0,0,38,6,0,44
17/08/2020,Hutt Valley,0,0,0,0,19,3,0,22
17/08/2020,Lakes,0,0,0,0,15,1,0,16
17/08/2020,Midcentral,0,0,0,0,27,5,0,32
17/08/2020,Nelson Marlborough,0,0,0,0,37,12,0,49
17/08/2020,Northland,0,0,0,0,26,2,0,28
17/08/2020,South Canterbury,0,0,0,0,15,2,0,17
17/08/2020,Southern,0,0,0,0,186,30,2,216
17/08/2020,Tairawhiti,0,0,0,0,3,1,0,4
17/08/2020,Taranaki,0,0,0,0,14,2,0,16
17/08/2020,Waikato,0,0,0,0,153,34,1,187
17/08/2020,Wairarapa,0,0,0,0,6,2,0,8
17/08/2020,Waitemata,0,0,0,0,175,71,4,246
17/08/2020,West Coast,0,0,0,0,4,1,1,5
17/08/2020,Whanganui,0,0,0,0,8,1,0,9
16/08/2020,Auckland,8,0,0,8,169,51,0,220
16/08/2020,Bay of Plenty,0,0,0,0,34,14,0,48
16/08/2020,Canterbury,0,0,0,0,113,65,12,178
16/08/2020,Capital and Coast,0,0,0,0,71,24,2,95
16/08/2020,Counties Manukau,4,0,0,4,169,23,0,192
16/08/2020,Hawke's Bay,0,0,0,0,38,6,0,44
16/08/2020,Hutt Valley,0,0,0,0,19,3,0,22
16/08/2020,Lakes,0,0,0,0,15,1,0,16
16/08/2020,Midcentral,0,0,0,0,27,5,0,32
16/08/2020,Nelson Marlborough,0,0,0,0,37,12,0,49
16/08/2020,Northland,0,0,0,0,26,2,0,28
16/08/2020,South Canterbury,0,0,0,0,15,2,0,17
16/08/2020,Southern,0,0,0,0,186,30,2,216
16/08/2020,Tairawhiti,0,0,0,0,3,1,0,4
16/08/2020,Taranaki,0,0,0,0,14,2,0,16
16/08/2020,Waikato,0,0,0,0,153,34,1,187
16/08/2020,Wairarapa,0,0,0,0,6,2,0,8
16/08/2020,Waitemata,0,0,0,0,175,71,4,246
16/08/2020,West Coast,0,0,0,0,4,1,1,5
16/08/2020,Whanganui,0,0,0,0,8,1,0,9
15/08/2020,Auckland,5,0,0,5,161,51,0,212
15/08/2020,Bay of Plenty,0,0,0,0,34,14,0,48
15/08/2020,Canterbury,0,0,0,0,113,65,12,178
15/08/2020,Capital and Coast,0,0,0,0,71,24,2,95
15/08/2020,Counties Manukau,6,0,0,6,165,23,0,188
15/08/2020,Hawke's Bay,0,0,0,0,38,6,0,44
15/08/2020,Hutt Valley,0,0,0,0,19,3,0,22
15/08/2020,Lakes,0,0,0,0,15,1,0,16
15/08/2020,Midcentral,0,0,0,0,27,5,0,32
15/08/2020,Nelson Marlborough,0,0,0,0,37,12,0,49
15/08/2020,Northland,0,0,0,0,26,2,0,28
15/08/2020,South Canterbury,0,0,0,0,15,2,0,17
15/08/2020,Southern,0,0,0,0,186,30,2,216
15/08/2020,Tairawhiti,0,0,0,0,3,1,0,4
15/08/2020,Taranaki,0,0,0,0,14,2,0,16
15/08/2020,Waikato,0,0,0,0,153,34,1,187
15/08/2020,Wairarapa,0,0,0,0,6,2,0,8
15/08/2020,Waitemata,3,0,0,3,175,71,4,246
15/08/2020,West Coast,0,0,0,0,4,1,1,5
15/08/2020,Whanganui,0,0,0,0,8,1,0,9
14/08/2020,Auckland,4,0,0,4,156,51,0,207
14/08/2020,Bay of Plenty,0,0,0,0,34,14,0,48
14/08/2020,Canterbury,0,0,0,0,113,65,12,178
14/08/2020,Capital and Coast,0,0,0,0,71,24,2,95
14/08/2020,Counties Manukau,1,0,0,1,159,23,0,182
14/08/2020,Hawke's Bay,0,0,0,0,38,6,0,44
14/08/2020,Hutt Valley,0,0,0,0,19,3,0,22
14/08/2020,Lakes,0,0,0,0,15,1,0,16
14/08/2020,Midcentral,0,0,0,0,27,5,0,32
14/08/2020,Nelson Marlborough,0,0,0,0,37,12,0,49
14/08/2020,Northland,0,0,0,0,26,2,0,28
14/08/2020,South Canterbury,0,0,0,0,15,2,0,17
14/08/2020,Southern,0,0,0,0,186,30,2,216
14/08/2020,Tairawhiti,0,0,0,0,3,1,0,4
14/08/2020,Taranaki,0,0,0,0,14,2,0,16
14/08/2020,Waikato,0,0,0,0,153,34,1,187
14/08/2020,Wairarapa,0,0,0,0,6,2,0,8
14/08/2020,Waitemata,0,0,0,0,172,71,4,243
14/08/2020,West Coast,0,0,0,0,4,1,1,5
14/08/2020,Whanganui,0,0,0,0,8,1,0,9
13/08/2020,Auckland,3,0,0,3,152,51,0,203
13/08/2020,Bay of Plenty,0,0,0,0,34,14,0,48
13/08/2020,Canterbury,0,0,0,0,113,65,12,178
13/08/2020,Capital and Coast,0,0,0,0,71,24,2,95
13/08/2020,Counties Manukau,7,0,0,7,158,23,0,181
13/08/2020,Hawke's Bay,0,0,0,0,38,6,0,44
13/08/2020,Hutt Valley,0,0,0,0,19,3,0,22
13/08/2020,Lakes,0,0,0,0,15,1,0,16
13/08/2020,Midcentral,0,0,0,0,27,5,0,32
13/08/2020,Nelson Marlborough,0,0,0,0,37,12,0,49
13/08/2020,Northland,0,0,0,0,26,2,0,28
13/08/2020,South Canterbury,0,0,0,0,15,2,0,17
13/08/2020,Southern,0,0,0,0,186,30,2,216
13/08/2020,Tairawhiti,0,0,0,0,3,1,0,4
13/08/2020,Taranaki,0,0,0,0,14,2,0,16
13/08/2020,Waikato,0,0,0,0,153,34,1,187
13/08/2020,Wairarapa,0,0,0,0,6,2,0,8
13/08/2020,Waitemata,2,0,0,2,172,71,4,243
13/08/2020,West Coast,0,0,0,0,4,1,1,5
13/08/2020,Whanganui,0,0,0,0,8,1,0,9
12/08/2020,Auckland,1,0,0,1,149,51,0,200
12/08/2020,Bay of Plenty,0,0,0,0,34,14,0,48
12/08/2020,Canterbury,0,0,0,0,113,65,12,178
12/08/2020,Capital and Coast,0,0,0,0,71,24,2,95
12/08/2020,Counties Manukau,10,0,0,10,151,23,0,174
12/08/2020,Hawke's Bay,0,0,0,0,38,6,0,44
12/08/2020,Hutt Valley,0,0,0,0,19,3,0,22
12/08/2020,Lakes,0,0,0,0,15,1,0,16
12/08/2020,Midcentral,0,0,0,0,27,5,0,32
12/08/2020,Nelson Marlborough,0,0,0,0,37,12,0,49
12/08/2020,Northland,0,0,0,0,26,2,0,28
12/08/2020,South Canterbury,0,0,0,0,15,2,0,17
12/08/2020,Southern,0,0,0,0,186,30,2,216
12/08/2020,Tairawhiti,0,0,0,0,3,1,0,4
12/08/2020,Taranaki,0,0,0,0,14,2,0,16
12/08/2020,Waikato,0,0,0,0,153,34,1,187
12/08/2020,Wairarapa,0,0,0,0,6,2,0,8
12/08/2020,Waitemata,4,0,0,4,170,71,4,241
12/08/2020,West Coast,0,0,0,0,4,1,1,5
12/08/2020,Whanganui,0,0,0,0,8,1,0,9
11/08/2020,Auckland,1,0,0,1,148,51,0,199
11/08/2020,Bay of Plenty,0,0,0,0,34,14,0,48
11/08/2020,Canterbury,0,0,0,0,113,65,12,178
11/08/2020,Capital and Coast,0,0,0,0,71,24,2,95
11/08/2020,Counties Manukau,4,0,0,4,141,23,0,164
11/08/2020,Hawke's Bay,0,0,0,0,38,6,0,44
11/08/2020,Hutt Valley,0,0,0,0,19,3,0,22
11/08/2020,Lakes,0,0,0,0,15,1,0,16
11/08/2020,Midcentral,0,0,0,0,27,5,0,32
11/08/2020,Nelson Marlborough,0,0,0,0,37,12,0,49
11/08/2020,Northland,0,0,0,0,26,2,0,28
11/08/2020,South Canterbury,0,0,0,0,15,2,0,17
11/08/2020,Southern,0,0,0,0,186,30,2,216
11/08/2020,Tairawhiti,0,0,0,0,3,1,0,4
11/08/2020,Taranaki,0,0,0,0,14,2,0,16
11/08/2020,Waikato,0,0,0,0,153,34,1,187
11/08/2020,Wairarapa,0,0,0,0,6,2,0,8
11/08/2020,Waitemata,0,0,0,0,166,71,4,237
11/08/2020,West Coast,0,0,0,0,4,1,1,5
11/08/2020,Whanganui,0,0,0,0,8,1,0,9
10/08/2020,Auckland,0,0,0,0,147,51,0,198
10/08/2020,Bay of Plenty,0,0,0,0,34,14,0,48
10/08/2020,Canterbury,0,0,0,0,113,65,12,178
10/08/2020,Capital and Coast,0,0,0,0,71,24,2,95
10/08/2020,Counties Manukau,0,0,0,0,137,23,0,160
10/08/2020,Hawke's Bay,0,0,0,0,38,6,0,44
10/08/2020,Hutt Valley,0,0,0,0,19,3,0,22
10/08/2020,Lakes,0,0,0,0,15,1,0,16
10/08/2020,Midcentral,0,0,0,0,27,5,0,32
10/08/2020,Nelson Marlborough,0,0,0,0,37,12,0,49
10/08/2020,Northland,0,0,0,0,26,2,0,28
10/08/2020,South Canterbury,0,0,0,0,15,2,0,17
10/08/2020,Southern,0,0,0,0,186,30,2,216
10/08/2020,Tairawhiti,0,0,0,0,3,1,0,4
10/08/2020,Taranaki,0,0,0,0,14,2,0,16
10/08/2020,Waikato,0,0,0,0,153,34,1,187
10/08/2020,Wairarapa,0,0,0,0,6,2,0,8
10/08/2020,Waitemata,0,0,0,0,166,71,4,237
10/08/2020,West Coast,0,0,0,0,4,1,1,5
10/08/2020,Whanganui,0,0,0,0,8,1,0,9
09/08/2020,Auckland,0,0,0,0,147,51,0,198
09/08/2020,Bay of Plenty,0,0,0,0,34,14,0,48
09/08/2020,Canterbury,0,0,0,0,113,65,12,178
09/08/2020,Capital and Coast,0,0,0,0,71,24,2,95
09/08/2020,Counties Manukau,0,0,0,0,137,23,0,160
09/08/2020,Hawke's Bay,0,0,0,0,38,6,0,44
09/08/2020,Hutt Valley,0,0,0,0,19,3,0,22
09/08/2020,Lakes,0,0,0,0,15,1,0,16
09/08/2020,Midcentral,0,0,0,0,27,5,0,32
09/08/2020,Nelson Marlborough,0,0,0,0,37,12,0,49
09/08/2020,Northland,0,0,0,0,26,2,0,28
09/08/2020,South Canterbury,0,0,0,0,15,2,0,17
09/08/2020,Southern,0,0,0,0,186,30,2,216
09/08/2020,Tairawhiti,0,0,0,0,3,1,0,4
09/08/2020,Taranaki,0,0,0,0,14,2,0,16
09/08/2020,Waikato,0,0,0,0,153,34,1,187
09/08/2020,Wairarapa,0,0,0,0,6,2,0,8
09/08/2020,Waitemata,0,0,0,0,166,71,4,237
09/08/2020,West Coast,0,0,0,0,4,1,1,5
09/08/2020,Whanganui,0,0,0,0,8,1,0,9
08/08/2020,Auckland,0,0,0,0,147,51,0,198
08/08/2020,Bay of Plenty,0,0,0,0,34,14,0,48
08/08/2020,Canterbury,0,0,0,0,113,65,12,178
08/08/2020,Capital and Coast,0,0,0,0,71,24,2,95
08/08/2020,Counties Manukau,0,0,0,0,137,23,0,160
08/08/2020,Hawke's Bay,0,0,0,0,38,6,0,44
08/08/2020,Hutt Valley,0,0,0,0,19,3,0,22
08/08/2020,Lakes,0,0,0,0,15,1,0,16
08/08/2020,Midcentral,0,0,0,0,27,5,0,32
08/08/2020,Nelson Marlborough,0,0,0,0,37,12,0,49
08/08/2020,Northland,0,0,0,0,26,2,0,28
08/08/2020,South Canterbury,0,0,0,0,15,2,0,17
08/08/2020,Southern,0,0,0,0,186,30,2,216
08/08/2020,Tairawhiti,0,0,0,0,3,1,0,4
08/08/2020,Taranaki,0,0,0,0,14,2,0,16
08/08/2020,Waikato,0,0,0,0,153,34,1,187
08/08/2020,Wairarapa,0,0,0,0,6,2,0,8
08/08/2020,Waitemata,0,0,0,0,166,71,4,237
08/08/2020,West Coast,0,0,0,0,4,1,1,5
08/08/2020,Whanganui,0,0,0,0,8,1,0,9
07/08/2020,Auckland,0,0,0,0,147,51,0,198
07/08/2020,Bay of Plenty,0,0,0,0,34,14,0,48
07/08/2020,Canterbury,0,0,0,0,113,65,12,178
07/08/2020,Capital and Coast,0,0,0,0,71,24,2,95
07/08/2020,Counties Manukau,0,0,0,0,137,23,0,160
07/08/2020,Hawke's Bay,0,0,0,0,38,6,0,44
07/08/2020,Hutt Valley,0,0,0,0,19,3,0,22
07/08/2020,Lakes,0,0,0,0,15,1,0,16
07/08/2020,Midcentral,0,0,0,0,27,5,0,32
07/08/2020,Nelson Marlborough,0,0,0,0,37,12,0,49
07/08/2020,Northland,0,0,0,0,26,2,0,28
07/08/2020,South Canterbury,0,0,0,0,15,2,0,17
07/08/2020,Southern,0,0,0,0,186,30,2,216
07/08/2020,Tairawhiti,0,0,0,0,3,1,0,4
07/08/2020,Taranaki,0,0,0,0,14,2,0,16
07/08/2020,Waikato,0,0,0,0,153,34,1,187
07/08/2020,Wairarapa,0,0,0,0,6,2,0,8
07/08/2020,Waitemata,0,0,0,0,166,71,4,237
07/08/2020,West Coast,0,0,0,0,4,1,1,5
07/08/2020,Whanganui,0,0,0,0,8,1,0,9
06/08/2020,Auckland,0,0,0,0,147,51,0,198
06/08/2020,Bay of Plenty,0,0,0,0,34,14,0,48
06/08/2020,Canterbury,0,0,0,0,113,65,12,178
06/08/2020,Capital and Coast,0,0,0,0,71,24,2,95
06/08/2020,Counties Manukau,0,0,0,0,137,23,0,160
06/08/2020,Hawke's Bay,0,0,0,0,38,6,0,44
06/08/2020,Hutt Valley,0,0,0,0,19,3,0,22
06/08/2020,Lakes,0,0,0,0,15,1,0,16
06/08/2020,Midcentral,0,0,0,0,27,5,0,32
06/08/2020,Nelson Marlborough,0,0,0,0,37,12,0,49
06/08/2020,Northland,0,0,0,0,26,2,0,28
06/08/2020,South Canterbury,0,0,0,0,15,2,0,17
06/08/2020,Southern,0,0,0,0,186,30,2,216
06/08/2020,Tairawhiti,0,0,0,0,3,1,0,4
06/08/2020,Taranaki,0,0,0,0,14,2,0,16
06/08/2020,Waikato,0,0,0,0,153,34,1,187
06/08/2020,Wairarapa,0,0,0,0,6,2,0,8
06/08/2020,Waitemata,0,0,0,0,166,71,4,237
06/08/2020,West Coast,0,0,0,0,4,1,1,5
06/08/2020,Whanganui,0,0,0,0,8,1,0,9
05/08/2020,Auckland,0,0,0,0,147,51,0,198
05/08/2020,Bay of Plenty,0,0,0,0,34,14,0,48
05/08/2020,Canterbury,0,0,0,0,113,65,12,178
05/08/2020,Capital and Coast,0,0,0,0,71,24,2,95
05/08/2020,Counties Manukau,0,0,0,0,137,23,0,160
05/08/2020,Hawke's Bay,0,0,0,0,38,6,0,44
05/08/2020,Hutt Valley,0,0,0,0,19,3,0,22
05/08/2020,Lakes,0,0,0,0,15,1,0,16
05/08/2020,Midcentral,0,0,0,0,27,5,0,32
05/08/2020,Nelson Marlborough,0,0,0,0,37,12,0,49
05/08/2020,Northland,0,0,0,0,26,2,0,28
05/08/2020,South Canterbury,0,0,0,0,15,2,0,17
05/08/2020,Southern,0,0,0,0,186,30,2,216
05/08/2020,Tairawhiti,0,0,0,0,3,1,0,4
05/08/2020,Taranaki,0,0,0,0,14,2,0,16
05/08/2020,Waikato,0,0,0,0,153,34,1,187
05/08/2020,Wairarapa,0,0,0,0,6,2,0,8
05/08/2020,Waitemata,0,0,0,0,166,71,4,237
05/08/2020,West Coast,0,0,0,0,4,1,1,5
05/08/2020,Whanganui,0,0,0,0,8,1,0,9
04/08/2020,Auckland,1,0,0,1,147,51,0,198
04/08/2020,Bay of Plenty,0,0,0,0,34,14,0,48
04/08/2020,Canterbury,0,0,0,0,113,65,12,178
04/08/2020,Capital and Coast,0,0,0,0,71,24,2,95
04/08/2020,Counties Manukau,1,0,0,1,137,23,0,160
04/08/2020,Hawke's Bay,0,0,0,0,38,6,0,44
04/08/2020,Hutt Valley,0,0,0,0,19,3,0,22
04/08/2020,Lakes,0,0,0,0,15,1,0,16
04/08/2020,Midcentral,0,0,0,0,27,5,0,32
04/08/2020,Nelson Marlborough,0,0,0,0,37,12,0,49
04/08/2020,Northland,0,0,0,0,26,2,0,28
04/08/2020,South Canterbury,0,0,0,0,15,2,0,17
04/08/2020,Southern,0,0,0,0,186,30,2,216
04/08/2020,Tairawhiti,0,0,0,0,3,1,0,4
04/08/2020,Taranaki,0,0,0,0,14,2,0,16
04/08/2020,Waikato,0,0,0,0,153,34,1,187
04/08/2020,Wairarapa,0,0,0,0,6,2,0,8
04/08/2020,Waitemata,0,0,0,0,166,71,4,237
04/08/2020,West Coast,0,0,0,0,4,1,1,5
04/08/2020,Whanganui,0,0,0,0,8,1,0,9
03/08/2020,Auckland,0,0,0,0,146,51,0,197
03/08/2020,Bay of Plenty,0,0,0,0,34,14,0,48
03/08/2020,Canterbury,0,0,0,0,113,65,12,178
03/08/2020,Capital and Coast,0,0,0,0,71,24,2,95
03/08/2020,Counties Manukau,0,0,0,0,136,23,0,159
03/08/2020,Hawke's Bay,0,0,0,0,38,6,0,44
03/08/2020,Hutt Valley,0,0,0,0,19,3,0,22
03/08/2020,Lakes,0,0,0,0,15,1,0,16
03/08/2020,Midcentral,0,0,0,0,27,5,0,32
03/08/2020,Nelson Marlborough,0,0,0,0,37,12,0,49
03/08/2020,Northland,0,0,0,0,26,2,0,28
03/08/2020,South Canterbury,0,0,0,0,15,2,0,17
03/08/2020,Southern,0,0,0,0,186,30,2,216
03/08/2020,Tairawhiti,0,0,0,0,3,1,0,4
03/08/2020,Taranaki,0,0,0,0,14,2,0,16
03/08/2020,Waikato,0,0,0,0,153,34,1,187
03/08/2020,Wairarapa,0,0,0,0,6,2,0,8
03/08/2020,Waitemata,0,0,0,0,166,71,4,237
03/08/2020,West Coast,0,0,0,0,4,1,1,5
03/08/2020,Whanganui,0,0,0,0,8,1,0,9
02/08/2020,Auckland,0,0,0,0,146,51,0,197
02/08/2020,Bay of Plenty,0,0,0,0,34,14,0,48
02/08/2020,Canterbury,1,0,0,1,113,65,12,178
02/08/2020,Capital and Coast,0,0,0,0,71,24,2,95
02/08/2020,Counties Manukau,2,0,0,2,136,23,0,159
02/08/2020,Hawke's Bay,0,0,0,0,38,6,0,44
02/08/2020,Hutt Valley,0,0,0,0,19,3,0,22
02/08/2020,Lakes,0,0,0,0,15,1,0,16
02/08/2020,Midcentral,0,0,0,0,27,5,0,32
02/08/2020,Nelson Marlborough,0,0,0,0,37,12,0,49
02/08/2020,Northland,0,0,0,0,26,2,0,28
02/08/2020,South Canterbury,0,0,0,0,15,2,0,17
02/08/2020,Southern,0,0,0,0,186,30,2,216
02/08/2020,Tairawhiti,0,0,0,0,3,1,0,4
02/08/2020,Taranaki,0,0,0,0,14,2,0,16
02/08/2020,Waikato,0,0,0,0,153,34,1,187
02/08/2020,Wairarapa,0,0,0,0,6,2,0,8
02/08/2020,Waitemata,0,0,0,0,166,71,4,237
02/08/2020,West Coast,0,0,0,0,4,1,1,5
02/08/2020,Whanganui,0,0,0,0,8,1,0,9
01/08/2020,Auckland,1,0,0,1,146,51,0,197
01/08/2020,Bay of Plenty,0,0,0,0,34,14,0,48
01/08/2020,Canterbury,0,0,0,0,112,65,12,177
01/08/2020,Capital and Coast,0,0,0,0,71,24,2,95
01/08/2020,Counties Manukau,1,0,0,1,134,23,0,157
01/08/2020,Hawke's Bay,0,0,0,0,38,6,0,44
01/08/2020,Hutt Valley,0,0,0,0,19,3,0,22
01/08/2020,Lakes,0,0,0,0,15,1,0,16
01/08/2020,Midcentral,0,0,0,0,27,5,0,32
01/08/2020,Nelson Marlborough,0,0,0,0,37,12,0,49
01/08/2020,Northland,0,0,0,0,26,2,0,28
01/08/2020,South Canterbury,0,0,0,0,15,2,0,17
01/08/2020,Southern,0,0,0,0,186,30,2,216
01/08/2020,Tairawhiti,0,0,0,0,3,1,0,4
01/08/2020,Taranaki,0,0,0,0,14,2,0,16
01/08/2020,Waikato,0,0,0,0,153,34,1,187
01/08/2020,Wairarapa,0,0,0,0,6,2,0,8
01/08/2020,Waitemata,0,0,0,0,166,71,4,237
01/08/2020,West Coast,0,0,0,0,4,1,1,5
01/08/2020,Whanganui,0,0,0,0,8,1,0,9
31/07/2020,Auckland,0,0,0,0,145,51,0,196
31/07/2020,Bay of Plenty,0,0,0,0,34,14,0,48
31/07/2020,Canterbury,0,0,0,0,112,65,12,177
31/07/2020,Capital and Coast,0,0,0,0,71,24,2,95
31/07/2020,Counties Manukau,2,0,0,2,133,23,0,156
31/07/2020,Hawke's Bay,0,0,0,0,38,6,0,44
31/07/2020,Hutt Valley,0,0,0,0,19,3,0,22
31/07/2020,Lakes,0,0,0,0,15,1,0,16
31/07/2020,Midcentral,0,0,0,0,27,5,0,32
31/07/2020,Nelson Marlborough,0,0,0,0,37,12,0,49
31/07/2020,Northland,0,0,0,0,26,2,0,28
31/07/2020,South Canterbury,0,0,0,0,15,2,0,17
31/07/2020,Southern,0,0,0,0,186,30,2,216
31/07/2020,Tairawhiti,0,0,0,0,3,1,0,4
31/07/2020,Taranaki,0,0,0,0,14,2,0,16
31/07/2020,Waikato,0,0,0,0,153,34,1,187
31/07/2020,Wairarapa,0,0,0,0,6,2,0,8
31/07/2020,Waitemata,0,0,0,0,166,71,4,237
31/07/2020,West Coast,0,0,0,0,4,1,1,5
31/07/2020,Whanganui,0,0,0,0,8,1,0,9
30/07/2020,Auckland,0,0,0,0,145,51,0,196
30/07/2020,Bay of Plenty,0,0,0,0,34,14,0,48
30/07/2020,Canterbury,0,0,0,0,112,65,12,177
30/07/2020,Capital and Coast,0,0,0,0,71,24,2,95
30/07/2020,Counties Manukau,0,0,0,0,131,23,0,154
30/07/2020,Hawke's Bay,0,0,0,0,38,6,0,44
30/07/2020,Hutt Valley,0,0,0,0,19,3,0,22
30/07/2020,Lakes,0,0,0,0,15,1,0,16
30/07/2020,Midcentral,0,0,0,0,27,5,0,32
30/07/2020,Nelson Marlborough,0,0,0,0,37,12,0,49
30/07/2020,Northland,0,0,0,0,26,2,0,28
30/07/2020,South Canterbury,0,0,0,0,15,2,0,17
30/07/2020,Southern,0,0,0,0,186,30,2,216
30/07/2020,Tairawhiti,0,0,0,0,3,1,0,4
30/07/2020,Taranaki,0,0,0,0,14,2,0,16
30/07/2020,Waikato,0,0,0,0,153,34,1,187
30/07/2020,Wairarapa,0,0,0,0,6,2,0,8
30/07/2020,Waitemata,0,0,0,0,166,71,4,237
30/07/2020,West Coast,0,0,0,0,4,1,1,5
30/07/2020,Whanganui,0,0,0,0,8,1,0,9
29/07/2020,Auckland,0,0,0,0,145,51,0,196
29/07/2020,Bay of Plenty,0,0,0,0,34,14,0,48
29/07/2020,Canterbury,0,0,0,0,112,65,12,177
29/07/2020,Capital and Coast,0,0,0,0,71,24,2,95
29/07/2020,Counties Manukau,1,0,0,1,131,23,0,154
29/07/2020,Hawke's Bay,0,0,0,0,38,6,0,44
29/07/2020,Hutt Valley,0,0,0,0,19,3,0,22
29/07/2020,Lakes,0,0,0,0,15,1,0,16
29/07/2020,Midcentral,0,0,0,0,27,5,0,32
29/07/2020,Nelson Marlborough,0,0,0,0,37,12,0,49
29/07/2020,Northland,0,0,0,0,26,2,0,28
29/07/2020,South Canterbury,0,0,0,0,15,2,0,17
29/07/2020,Southern,0,0,0,0,186,30,2,216
29/07/2020,Tairawhiti,0,0,0,0,3,1,0,4
29/07/2020,Taranaki,0,0,0,0,14,2,0,16
29/07/2020,Waikato,0,0,0,0,153,34,1,187
29/07/2020,Wairarapa,0,0,0,0,6,2,0,8
29/07/2020,Waitemata,0,0,0,0,166,71,4,237
29/07/2020,West Coast,0,0,0,0,4,1,1,5
29/07/2020,Whanganui,0,0,0,0,8,1,0,9
28/07/2020,Auckland,0,0,0,0,145,51,0,196
28/07/2020,Bay of Plenty,0,0,0,0,34,14,0,48
28/07/2020,Canterbury,0,0,0,0,112,65,12,177
28/07/2020,Capital and Coast,0,0,0,0,71,24,2,95
28/07/2020,Counties Manukau,1,0,0,1,130,23,0,153
28/07/2020,Hawke's Bay,0,0,0,0,38,6,0,44
28/07/2020,Hutt Valley,0,0,0,0,19,3,0,22
28/07/2020,Lakes,0,0,0,0,15,1,0,16
28/07/2020,Midcentral,0,0,0,0,27,5,0,32
28/07/2020,Nelson Marlborough,0,0,0,0,37,12,0,49
28/07/2020,Northland,0,0,0,0,26,2,0,28
28/07/2020,South Canterbury,0,0,0,0,15,2,0,17
28/07/2020,Southern,0,0,0,0,186,30,2,216
28/07/2020,Tairawhiti,0,0,0,0,3,1,0,4
28/07/2020,Taranaki,0,0,0,0,14,2,0,16
28/07/2020,Waikato,0,0,0,0,153,34,1,187
28/07/2020,Wairarapa,0,0,0,0,6,2,0,8
28/07/2020,Waitemata,0,0,0,0,166,71,4,237
28/07/2020,West Coast,0,0,0,0,4,1,1,5
28/07/2020,Whanganui,0,0,0,0,8,1,0,9
27/07/2020,Auckland,0,0,0,0,145,51,0,196
27/07/2020,Bay of Plenty,0,0,0,0,34,14,0,48
27/07/2020,Canterbury,0,0,0,0,112,65,12,177
27/07/2020,Capital and Coast,0,0,0,0,71,24,2,95
27/07/2020,Counties Manukau,2,0,0,2,129,23,0,152
27/07/2020,Hawke's Bay,0,0,0,0,38,6,0,44
27/07/2020,Hutt Valley,0,0,0,0,19,3,0,22
27/07/2020,Lakes,0,0,0,0,15,1,0,16
27/07/2020,Midcentral,0,0,0,0,27,5,0,32
27/07/2020,Nelson Marlborough,0,0,0,0,37,12,0,49
27/07/2020,Northland,0,0,0,0,26,2,0,28
27/07/2020,South Canterbury,0,0,0,0,15,2,0,17
27/07/2020,Southern,0,0,0,0,186,30,2,216
27/07/2020,Tairawhiti,0,0,0,0,3,1,0,4
27/07/2020,Taranaki,0,0,0,0,14,2,0,16
27/07/2020,Waikato,0,0,0,0,153,34,1,187
27/07/2020,Wairarapa,0,0,0,0,6,2,0,8
27/07/2020,Waitemata,0,0,0,0,166,71,4,237
27/07/2020,West Coast,0,0,0,0,4,1,1,5
27/07/2020,Whanganui,0,0,0,0,8,1,0,9
26/07/2020,Auckland,0,0,0,0,145,51,0,196
26/07/2020,Bay of Plenty,0,0,0,0,34,14,0,48
26/07/2020,Canterbury,0,0,0,0,112,65,12,177
26/07/2020,Capital and Coast,0,0,0,0,71,24,2,95
26/07/2020,Counties Manukau,0,0,0,0,127,23,0,150
26/07/2020,Hawke's Bay,0,0,0,0,38,6,0,44
26/07/2020,Hutt Valley,0,0,0,0,19,3,0,22
26/07/2020,Lakes,0,0,0,0,15,1,0,16
26/07/2020,Midcentral,0,0,0,0,27,5,0,32
26/07/2020,Nelson Marlborough,0,0,0,0,37,12,0,49
26/07/2020,Northland,0,0,0,0,26,2,0,28
26/07/2020,South Canterbury,0,0,0,0,15,2,0,17
26/07/2020,Southern,0,0,0,0,186,30,2,216
26/07/2020,Tairawhiti,0,0,0,0,3,1,0,4
26/07/2020,Taranaki,0,0,0,0,14,2,0,16
26/07/2020,Waikato,0,0,0,0,153,34,1,187
26/07/2020,Wairarapa,0,0,0,0,6,2,0,8
26/07/2020,Waitemata,0,0,0,0,166,71,4,237
26/07/2020,West Coast,0,0,0,0,4,1,1,5
26/07/2020,Whanganui,0,0,0,0,8,1,0,9
25/07/2020,Auckland,0,0,0,0,145,51,0,196
25/07/2020,Bay of Plenty,0,0,0,0,34,14,0,48
25/07/2020,Canterbury,0,0,0,0,112,65,12,177
25/07/2020,Capital and Coast,0,0,0,0,71,24,2,95
25/07/2020,Counties Manukau,0,0,0,0,127,23,0,150
25/07/2020,Hawke's Bay,0,0,0,0,38,6,0,44
25/07/2020,Hutt Valley,0,0,0,0,19,3,0,22
25/07/2020,Lakes,0,0,0,0,15,1,0,16
25/07/2020,Midcentral,0,0,0,0,27,5,0,32
25/07/2020,Nelson Marlborough,0,0,0,0,37,12,0,49
25/07/2020,Northland,0,0,0,0,26,2,0,28
25/07/2020,South Canterbury,0,0,0,0,15,2,0,17
25/07/2020,Southern,0,0,0,0,186,30,2,216
25/07/2020,Tairawhiti,0,0,0,0,3,1,0,4
25/07/2020,Taranaki,0,0,0,0,14,2,0,16
25/07/2020,Waikato,0,0,0,0,153,34,1,187
25/07/2020,Wairarapa,0,0,0,0,6,2,0,8
25/07/2020,Waitemata,0,0,0,0,166,71,4,237
25/07/2020,West Coast,0,0,0,0,4,1,1,5
25/07/2020,Whanganui,0,0,0,0,8,1,0,9
24/07/2020,Auckland,0,0,0,0,145,51,0,196
24/07/2020,Bay of Plenty,0,0,0,0,34,14,0,48
24/07/2020,Canterbury,0,0,0,0,112,65,12,177
24/07/2020,Capital and Coast,0,0,0,0,71,24,2,95
24/07/2020,Counties Manukau,1,0,0,1,127,23,0,150
24/07/2020,Hawke's Bay,0,0,0,0,38,6,0,44
24/07/2020,Hutt Valley,0,0,0,0,19,3,0,22
24/07/2020,Lakes,0,0,0,0,15,1,0,16
24/07/2020,Midcentral,0,0,0,0,27,5,0,32
24/07/2020,Nelson Marlborough,0,0,0,0,37,12,0,49
24/07/2020,Northland,0,0,0,0,26,2,0,28
24/07/2020,South Canterbury,0,0,0,0,15,2,0,17
24/07/2020,Southern,0,0,0,0,186,30,2,216
24/07/2020,Tairawhiti,0,0,0,0,3,1,0,4
24/07/2020,Taranaki,0,0,0,0,14,2,0,16
24/07/2020,Waikato,0,0,0,0,153,34,1,187
24/07/2020,Wairarapa,0,0,0,0,6,2,0,8
24/07/2020,Waitemata,0,0,0,0,166,71,4,237
24/07/2020,West Coast,0,0,0,0,4,1,1,5
24/07/2020,Whanganui,0,0,0,0,8,1,0,9
23/07/2020,Auckland,0,0,0,0,145,51,0,196
23/07/2020,Bay of Plenty,0,0,0,0,34,14,0,48
23/07/2020,Canterbury,0,0,0,0,112,65,12,177
23/07/2020,Capital and Coast,0,0,0,0,71,24,2,95
23/07/2020,Counties Manukau,0,0,0,0,126,23,0,149
23/07/2020,Hawke's Bay,0,0,0,0,38,6,0,44
23/07/2020,Hutt Valley,0,0,0,0,19,3,0,22
23/07/2020,Lakes,0,0,0,0,15,1,0,16
23/07/2020,Midcentral,0,0,0,0,27,5,0,32
23/07/2020,Nelson Marlborough,0,0,0,0,37,12,0,49
23/07/2020,Northland,0,0,0,0,26,2,0,28
23/07/2020,South Canterbury,0,0,0,0,15,2,0,17
23/07/2020,Southern,0,0,0,0,186,30,2,216
23/07/2020,Tairawhiti,0,0,0,0,3,1,0,4
23/07/2020,Taranaki,0,0,0,0,14,2,0,16
23/07/2020,Waikato,0,0,0,0,153,34,1,187
23/07/2020,Wairarapa,0,0,0,0,6,2,0,8
23/07/2020,Waitemata,0,0,0,0,166,71,4,237
23/07/2020,West Coast,0,0,0,0,4,1,1,5
23/07/2020,Whanganui,0,0,0,0,8,1,0,9
22/07/2020,Auckland,0,0,0,0,145,51,0,196
22/07/2020,Bay of Plenty,0,0,0,0,34,14,0,48
22/07/2020,Canterbury,0,0,0,0,112,65,12,177
22/07/2020,Capital and Coast,0,0,0,0,71,24,2,95
22/07/2020,Counties Manukau,0,0,0,0,126,23,0,149
22/07/2020,Hawke's Bay,0,0,0,0,38,6,0,44
22/07/2020,Hutt Valley,0,0,0,0,19,3,0,22
22/07/2020,Lakes,0,0,0,0,15,1,0,16
22/07/2020,Midcentral,0,0,0,0,27,5,0,32
22/07/2020,Nelson Marlborough,0,0,0,0,37,12,0,49
22/07/2020,Northland,0,0,0,0,26,2,0,28
22/07/2020,South Canterbury,0,0,0,0,15,2,0,17
22/07/2020,Southern,0,0,0,0,186,30,2,216
22/07/2020,Tairawhiti,0,0,0,0,3,1,0,4
22/07/2020,Taranaki,0,0,0,0,14,2,0,16
22/07/2020,Waikato,0,0,0,0,153,34,1,187
22/07/2020,Wairarapa,0,0,0,0,6,2,0,8
22/07/2020,Waitemata,0,0,0,0,166,71,4,237
22/07/2020,West Coast,0,0,0,0,4,1,1,5
22/07/2020,Whanganui,0,0,0,0,8,1,0,9
21/07/2020,Auckland,0,0,0,0,145,51,0,196
21/07/2020,Bay of Plenty,0,0,0,0,34,14,0,48
21/07/2020,Canterbury,0,0,0,0,112,65,12,177
21/07/2020,Capital and Coast,0,0,0,0,71,24,2,95
21/07/2020,Counties Manukau,0,0,0,0,126,23,0,149
21/07/2020,Hawke's Bay,0,0,0,0,38,6,0,44
21/07/2020,Hutt Valley,0,0,0,0,19,3,0,22
21/07/2020,Lakes,0,0,0,0,15,1,0,16
21/07/2020,Midcentral,0,0,0,0,27,5,0,32
21/07/2020,Nelson Marlborough,0,0,0,0,37,12,0,49
21/07/2020,Northland,0,0,0,0,26,2,0,28
21/07/2020,South Canterbury,0,0,0,0,15,2,0,17
21/07/2020,Southern,0,0,0,0,186,30,2,216
21/07/2020,Tairawhiti,0,0,0,0,3,1,0,4
21/07/2020,Taranaki,0,0,0,0,14,2,0,16
21/07/2020,Waikato,0,0,0,0,153,34,1,187
21/07/2020,Wairarapa,0,0,0,0,6,2,0,8
21/07/2020,Waitemata,0,0,0,0,166,71,4,237
21/07/2020,West Coast,0,0,0,0,4,1,1,5
21/07/2020,Whanganui,0,0,0,0,8,1,0,9
20/07/2020,Auckland,1,0,0,1,145,51,0,196
20/07/2020,Bay of Plenty,0,0,0,0,34,14,0,48
20/07/2020,Canterbury,0,0,0,0,112,65,12,177
20/07/2020,Capital and Coast,0,0,0,0,71,24,2,95
20/07/2020,Counties Manukau,0,0,0,0,126,23,0,149
20/07/2020,Hawke's Bay,0,0,0,0,38,6,0,44
20/07/2020,Hutt Valley,0,0,0,0,19,3,0,22
20/07/2020,Lakes,0,0,0,0,15,1,0,16
20/07/2020,Midcentral,0,0,0,0,27,5,0,32
20/07/2020,Nelson Marlborough,0,0,0,0,37,12,0,49
20/07/2020,Northland,0,0,0,0,26,2,0,28
20/07/2020,South Canterbury,0,0,0,0,15,2,0,17
20/07/2020,Southern,0,0,0,0,186,30,2,216
20/07/2020,Tairawhiti,0,0,0,0,3,1,0,4
20/07/2020,Taranaki,0,0,0,0,14,2,0,16
20/07/2020,Waikato,0,0,0,0,153,34,1,187
20/07/2020,Wairarapa,0,0,0,0,6,2,0,8
20/07/2020,Waitemata,0,0,0,0,166,71,4,237
20/07/2020,West Coast,0,0,0,0,4,1,1,5
20/07/2020,Whanganui,0,0,0,0,8,1,0,9
19/07/2020,Auckland,1,0,0,1,144,51,0,195
19/07/2020,Bay of Plenty,0,0,0,0,34,14,0,48
19/07/2020,Canterbury,0,0,0,0,112,65,12,177
19/07/2020,Capital and Coast,0,0,0,0,71,24,2,95
19/07/2020,Counties Manukau,0,0,0,0,126,23,0,149
19/07/2020,Hawke's Bay,0,0,0,0,38,6,0,44
19/07/2020,Hutt Valley,0,0,0,0,19,3,0,22
19/07/2020,Lakes,0,0,0,0,15,1,0,16
19/07/2020,Midcentral,0,0,0,0,27,5,0,32
19/07/2020,Nelson Marlborough,0,0,0,0,37,12,0,49
19/07/2020,Northland,0,0,0,0,26,2,0,28
19/07/2020,South Canterbury,0,0,0,0,15,2,0,17
19/07/2020,Southern,0,0,0,0,186,30,2,216
19/07/2020,Tairawhiti,0,0,0,0,3,1,0,4
19/07/2020,Taranaki,0,0,0,0,14,2,0,16
19/07/2020,Waikato,0,0,0,0,153,34,1,187
19/07/2020,Wairarapa,0,0,0,0,6,2,0,8
19/07/2020,Waitemata,0,0,0,0,166,71,4,237
19/07/2020,West Coast,0,0,0,0,4,1,1,5
19/07/2020,Whanganui,0,0,0,0,8,1,0,9
18/07/2020,Auckland,0,0,0,0,143,51,0,194
18/07/2020,Bay of Plenty,0,0,0,0,34,14,0,48
18/07/2020,Canterbury,0,0,0,0,112,65,12,177
18/07/2020,Capital and Coast,0,0,0,0,71,24,2,95
18/07/2020,Counties Manukau,2,0,0,2,126,23,0,149
18/07/2020,Hawke's Bay,0,0,0,0,38,6,0,44
18/07/2020,Hutt Valley,0,0,0,0,19,3,0,22
18/07/2020,Lakes,0,0,0,0,15,1,0,16
18/07/2020,Midcentral,0,0,0,0,27,5,0,32
18/07/2020,Nelson Marlborough,0,0,0,0,37,12,0,49
18/07/2020,Northland,0,0,0,0,26,2,0,28
18/07/2020,South Canterbury,0,0,0,0,15,2,0,17
18/07/2020,Southern,0,0,0,0,186,30,2,216
18/07/2020,Tairawhiti,0,0,0,0,3,1,0,4
18/07/2020,Taranaki,0,0,0,0,14,2,0,16
18/07/2020,Waikato,0,0,0,0,153,34,1,187
18/07/2020,Wairarapa,0,0,0,0,6,2,0,8
18/07/2020,Waitemata,0,0,0,0,166,71,4,237
18/07/2020,West Coast,0,0,0,0,4,1,1,5
18/07/2020,Whanganui,0,0,0,0,8,1,0,9
17/07/2020,Auckland,0,0,0,0,143,51,0,194
17/07/2020,Bay of Plenty,0,0,0,0,34,14,0,48
17/07/2020,Canterbury,1,0,0,1,112,65,12,177
17/07/2020,Capital and Coast,0,0,0,0,71,24,2,95
17/07/2020,Counties Manukau,1,0,0,1,124,23,0,147
17/07/2020,Hawke's Bay,0,0,0,0,38,6,0,44
17/07/2020,Hutt Valley,0,0,0,0,19,3,0,22
17/07/2020,Lakes,0,0,0,0,15,1,0,16
17/07/2020,Midcentral,0,0,0,0,27,5,0,32
17/07/2020,Nelson Marlborough,0,0,0,0,37,12,0,49
17/07/2020,Northland,0,0,0,0,26,2,0,28
17/07/2020,South Canterbury,0,0,0,0,15,2,0,17
17/07/2020,Southern,0,0,0,0,186,30,2,216
17/07/2020,Tairawhiti,0,0,0,0,3,1,0,4
17/07/2020,Taranaki,0,0,0,0,14,2,0,16
17/07/2020,Waikato,0,0,0,0,153,34,1,187
17/07/2020,Wairarapa,0,0,0,0,6,2,0,8
17/07/2020,Waitemata,0,0,0,0,166,71,4,237
17/07/2020,West Coast,0,0,0,0,4,1,1,5
17/07/2020,Whanganui,0,0,0,0,8,1,0,9
16/07/2020,Auckland,0,0,0,0,143,51,0,194
16/07/2020,Bay of Plenty,0,0,0,0,34,14,0,48
16/07/2020,Canterbury,0,0,0,0,111,65,12,176
16/07/2020,Capital and Coast,0,0,0,0,71,24,2,95
16/07/2020,Counties Manukau,1,0,0,1,123,23,0,146
16/07/2020,Hawke's Bay,0,0,0,0,38,6,0,44
16/07/2020,Hutt Valley,0,0,0,0,19,3,0,22
16/07/2020,Lakes,0,0,0,0,15,1,0,16
16/07/2020,Midcentral,0,0,0,0,27,5,0,32
16/07/2020,Nelson Marlborough,0,0,0,0,37,12,0,49
16/07/2020,Northland,0,0,0,0,26,2,0,28
16/07/2020,South Canterbury,0,0,0,0,15,2,0,17
16/07/2020,Southern,0,0,0,0,186,30,2,216
16/07/2020,Tairawhiti,0,0,0,0,3,1,0,4
16/07/2020,Taranaki,0,0,0,0,14,2,0,16
16/07/2020,Waikato,0,0,0,0,153,34,1,187
16/07/2020,Wairarapa,0,0,0,0,6,2,0,8
16/07/2020,Waitemata,0,0,0,0,166,71,4,237
16/07/2020,West Coast,0,0,0,0,4,1,1,5
16/07/2020,Whanganui,0,0,0,0,8,1,0,9
15/07/2020,Auckland,0,0,0,0,143,51,0,194
15/07/2020,Bay of Plenty,0,0,0,0,34,14,0,48
15/07/2020,Canterbury,0,0,0,0,111,65,12,176
15/07/2020,Capital and Coast,0,0,0,0,71,24,2,95
15/07/2020,Counties Manukau,0,0,0,0,122,23,0,145
15/07/2020,Hawke's Bay,0,0,0,0,38,6,0,44
15/07/2020,Hutt Valley,0,0,0,0,19,3,0,22
15/07/2020,Lakes,0,0,0,0,15,1,0,16
15/07/2020,Midcentral,0,0,0,0,27,5,0,32
15/07/2020,Nelson Marlborough,0,0,0,0,37,12,0,49
15/07/2020,Northland,0,0,0,0,26,2,0,28
15/07/2020,South Canterbury,0,0,0,0,15,2,0,17
15/07/2020,Southern,0,0,0,0,186,30,2,216
15/07/2020,Tairawhiti,0,0,0,0,3,1,0,4
15/07/2020,Taranaki,0,0,0,0,14,2,0,16
15/07/2020,Waikato,0,0,0,0,153,34,1,187
15/07/2020,Wairarapa,0,0,0,0,6,2,0,8
15/07/2020,Waitemata,0,0,0,0,166,71,4,237
15/07/2020,West Coast,0,0,0,0,4,1,1,5
15/07/2020,Whanganui,0,0,0,0,8,1,0,9
14/07/2020,Auckland,0,0,0,0,143,51,0,194
14/07/2020,Bay of Plenty,0,0,0,0,34,14,0,48
14/07/2020,Canterbury,1,0,0,1,111,65,12,176
14/07/2020,Capital and Coast,0,0,0,0,71,24,2,95
14/07/2020,Counties Manukau,2,0,0,2,122,23,0,145
14/07/2020,Hawke's Bay,0,0,0,0,38,6,0,44
14/07/2020,Hutt Valley,0,0,0,0,19,3,0,22
14/07/2020,Lakes,0,0,0,0,15,1,0,16
14/07/2020,Midcentral,0,0,0,0,27,5,0,32
14/07/2020,Nelson Marlborough,0,0,0,0,37,12,0,49
14/07/2020,Northland,0,0,0,0,26,2,0,28
14/07/2020,South Canterbury,0,0,0,0,15,2,0,17
14/07/2020,Southern,0,0,0,0,186,30,2,216
14/07/2020,Tairawhiti,0,0,0,0,3,1,0,4
14/07/2020,Taranaki,0,0,0,0,14,2,0,16
14/07/2020,Waikato,0,0,0,0,153,34,1,187
14/07/2020,Wairarapa,0,0,0,0,6,2,0,8
14/07/2020,Waitemata,0,0,0,0,166,71,4,237
14/07/2020,West Coast,0,0,0,0,4,1,1,5
14/07/2020,Whanganui,0,0,0,0,8,1,0,9
13/07/2020,Auckland,0,0,0,0,143,51,0,194
13/07/2020,Bay of Plenty,0,0,0,0,34,14,0,48
13/07/2020,Canterbury,1,0,0,1,110,65,12,175
13/07/2020,Capital and Coast,0,0,0,0,71,24,2,95
13/07/2020,Counties Manukau,0,0,0,0,120,23,0,143
13/07/2020,Hawke's Bay,0,0,0,0,38,6,0,44
13/07/2020,Hutt Valley,0,0,0,0,19,3,0,22
13/07/2020,Lakes,0,0,0,0,15,1,0,16
13/07/2020,Midcentral,0,0,0,0,27,5,0,32
13/07/2020,Nelson Marlborough,0,0,0,0,37,12,0,49
13/07/2020,Northland,0,0,0,0,26,2,0,28
13/07/2020,South Canterbury,0,0,0,0,15,2,0,17
13/07/2020,Southern,0,0,0,0,186,30,2,216
13/07/2020,Tairawhiti,0,0,0,0,3,1,0,4
13/07/2020,Taranaki,0,0,0,0,14,2,0,16
13/07/2020,Waikato,0,0,0,0,153,34,1,187
13/07/2020,Wairarapa,0,0,0,0,6,2,0,8
13/07/2020,Waitemata,0,0,0,0,166,71,4,237
13/07/2020,West Coast,0,0,0,0,4,1,1,5
13/07/2020,Whanganui,0,0,0,0,8,1,0,9
12/07/2020,Auckland,0,0,0,0,143,51,0,194
12/07/2020,Bay of Plenty,0,0,0,0,34,14,0,48
12/07/2020,Canterbury,0,0,0,0,109,65,12,174
12/07/2020,Capital and Coast,0,0,0,0,71,24,2,95
12/07/2020,Counties Manukau,0,0,0,0,120,23,0,143
12/07/2020,Hawke's Bay,0,0,0,0,38,6,0,44
12/07/2020,Hutt Valley,0,0,0,0,19,3,0,22
12/07/2020,Lakes,0,0,0,0,15,1,0,16
12/07/2020,Midcentral,0,0,0,0,27,5,0,32
12/07/2020,Nelson Marlborough,0,0,0,0,37,12,0,49
12/07/2020,Northland,0,0,0,0,26,2,0,28
12/07/2020,South Canterbury,0,0,0,0,15,2,0,17
12/07/2020,Southern,0,0,0,0,186,30,2,216
12/07/2020,Tairawhiti,0,0,0,0,3,1,0,4
12/07/2020,Taranaki,0,0,0,0,14,2,0,16
12/07/2020,Waikato,0,0,0,0,153,34,1,187
12/07/2020,Wairarapa,0,0,0,0,6,2,0,8
12/07/2020,Waitemata,0,0,0,0,166,71,4,237
12/07/2020,West Coast,0,0,0,0,4,1,1,5
12/07/2020,Whanganui,0,0,0,0,8,1,0,9
11/07/2020,Auckland,0,0,0,0,143,51,0,194
11/07/2020,Bay of Plenty,0,0,0,0,34,14,0,48
11/07/2020,Canterbury,1,0,0,1,109,65,12,174
11/07/2020,Capital and Coast,0,0,0,0,71,24,2,95
11/07/2020,Counties Manukau,0,0,0,0,120,23,0,143
11/07/2020,Hawke's Bay,0,0,0,0,38,6,0,44
11/07/2020,Hutt Valley,0,0,0,0,19,3,0,22
11/07/2020,Lakes,0,0,0,0,15,1,0,16
11/07/2020,Midcentral,0,0,0,0,27,5,0,32
11/07/2020,Nelson Marlborough,0,0,0,0,37,12,0,49
11/07/2020,Northland,0,0,0,0,26,2,0,28
11/07/2020,South Canterbury,0,0,0,0,15,2,0,17
11/07/2020,Southern,0,0,0,0,186,30,2,216
11/07/2020,Tairawhiti,0,0,0,0,3,1,0,4
11/07/2020,Taranaki,0,0,0,0,14,2,0,16
11/07/2020,Waikato,0,0,0,0,153,34,1,187
11/07/2020,Wairarapa,0,0,0,0,6,2,0,8
11/07/2020,Waitemata,0,0,0,0,166,71,4,237
11/07/2020,West Coast,0,0,0,0,4,1,1,5
11/07/2020,Whanganui,0,0,0,0,8,1,0,9
10/07/2020,Auckland,0,0,0,0,143,51,0,194
10/07/2020,Bay of Plenty,0,0,0,0,34,14,0,48
10/07/2020,Canterbury,0,0,0,0,108,65,12,173
10/07/2020,Capital and Coast,0,0,0,0,71,24,2,95
10/07/2020,Counties Manukau,0,0,0,0,120,23,0,143
10/07/2020,Hawke's Bay,0,0,0,0,38,6,0,44
10/07/2020,Hutt Valley,0,0,0,0,19,3,0,22
10/07/2020,Lakes,0,0,0,0,15,1,0,16
10/07/2020,Midcentral,0,0,0,0,27,5,0,32
10/07/2020,Nelson Marlborough,0,0,0,0,37,12,0,49
10/07/2020,Northland,0,0,0,0,26,2,0,28
10/07/2020,South Canterbury,0,0,0,0,15,2,0,17
10/07/2020,Southern,0,0,0,0,186,30,2,216
10/07/2020,Tairawhiti,0,0,0,0,3,1,0,4
10/07/2020,Taranaki,0,0,0,0,14,2,0,16
10/07/2020,Waikato,0,0,0,0,153,34,1,187
10/07/2020,Wairarapa,0,0,0,0,6,2,0,8
10/07/2020,Waitemata,0,0,0,0,166,71,4,237
10/07/2020,West Coast,0,0,0,0,4,1,1,5
10/07/2020,Whanganui,0,0,0,0,8,1,0,9
09/07/2020,Auckland,0,0,0,0,143,51,0,194
09/07/2020,Bay of Plenty,0,0,0,0,34,14,0,48
09/07/2020,Canterbury,1,0,0,1,108,65,12,173
09/07/2020,Capital and Coast,0,0,0,0,71,24,2,95
09/07/2020,Counties Manukau,2,0,0,2,120,23,0,143
09/07/2020,Hawke's Bay,0,0,0,0,38,6,0,44
09/07/2020,Hutt Valley,0,0,0,0,19,3,0,22
09/07/2020,Lakes,0,0,0,0,15,1,0,16
09/07/2020,Midcentral,0,0,0,0,27,5,0,32
09/07/2020,Nelson Marlborough,0,0,0,0,37,12,0,49
09/07/2020,Northland,0,0,0,0,26,2,0,28
09/07/2020,South Canterbury,0,0,0,0,15,2,0,17
09/07/2020,Southern,0,0,0,0,186,30,2,216
09/07/2020,Tairawhiti,0,0,0,0,3,1,0,4
09/07/2020,Taranaki,0,0,0,0,14,2,0,16
09/07/2020,Waikato,0,0,0,0,153,34,1,187
09/07/2020,Wairarapa,0,0,0,0,6,2,0,8
09/07/2020,Waitemata,0,0,0,0,166,71,4,237
09/07/2020,West Coast,0,0,0,0,4,1,1,5
09/07/2020,Whanganui,0,0,0,0,8,1,0,9
08/07/2020,Auckland,1,0,0,1,143,51,0,194
08/07/2020,Bay of Plenty,0,0,0,0,34,14,0,48
08/07/2020,Canterbury,1,0,0,1,107,65,12,172
08/07/2020,Capital and Coast,0,0,0,0,71,24,2,95
08/07/2020,Counties Manukau,0,0,0,0,118,23,0,141
08/07/2020,Hawke's Bay,0,0,0,0,38,6,0,44
08/07/2020,Hutt Valley,0,0,0,0,19,3,0,22
08/07/2020,Lakes,0,0,0,0,15,1,0,16
08/07/2020,Midcentral,0,0,0,0,27,5,0,32
08/07/2020,Nelson Marlborough,0,0,0,0,37,12,0,49
08/07/2020,Northland,0,0,0,0,26,2,0,28
08/07/2020,South Canterbury,0,0,0,0,15,2,0,17
08/07/2020,Southern,0,0,0,0,186,30,2,216
08/07/2020,Tairawhiti,0,0,0,0,3,1,0,4
08/07/2020,Taranaki,0,0,0,0,14,2,0,16
08/07/2020,Waikato,0,0,0,0,153,34,1,187
08/07/2020,Wairarapa,0,0,0,0,6,2,0,8
08/07/2020,Waitemata,0,0,0,0,166,71,4,237
08/07/2020,West Coast,0,0,0,0,4,1,1,5
08/07/2020,Whanganui,0,0,0,0,8,1,0,9
07/07/2020,Auckland,2,0,0,2,142,51,0,193
07/07/2020,Bay of Plenty,0,0,0,0,34,14,0,48
07/07/2020,Canterbury,0,0,0,0,106,65,12,171
07/07/2020,Capital and Coast,0,0,0,0,71,24,2,95
07/07/2020,Counties Manukau,0,0,0,0,118,23,0,141
07/07/2020,Hawke's Bay,0,0,0,0,38,6,0,44
07/07/2020,Hutt Valley,0,0,0,0,19,3,0,22
07/07/2020,Lakes,0,0,0,0,15,1,0,16
07/07/2020,Midcentral,0,0,0,0,27,5,0,32
07/07/2020,Nelson Marlborough,0,0,0,0,37,12,0,49
07/07/2020,Northland,0,0,0,0,26,2,0,28
07/07/2020,South Canterbury,0,0,0,0,15,2,0,17
07/07/2020,Southern,0,0,0,0,186,30,2,216
07/07/2020,Tairawhiti,0,0,0,0,3,1,0,4
07/07/2020,Taranaki,0,0,0,0,14,2,0,16
07/07/2020,Waikato,0,0,0,0,153,34,1,187
07/07/2020,Wairarapa,0,0,0,0,6,2,0,8
07/07/2020,Waitemata,0,0,0,0,166,71,4,237
07/07/2020,West Coast,0,0,0,0,4,1,1,5
07/07/2020,Whanganui,0,0,0,0,8,1,0,9
06/07/2020,Auckland,0,0,0,0,140,51,0,191
06/07/2020,Bay of Plenty,0,0,0,0,34,14,0,48
06/07/2020,Canterbury,2,0,0,2,106,65,12,171
06/07/2020,Capital and Coast,0,0,0,0,71,24,2,95
06/07/2020,Counties Manukau,1,0,0,1,118,23,0,141
06/07/2020,Hawke's Bay,0,0,0,0,38,6,0,44
06/07/2020,Hutt Valley,0,0,0,0,19,3,0,22
06/07/2020,Lakes,0,0,0,0,15,1,0,16
06/07/2020,Midcentral,0,0,0,0,27,5,0,32
06/07/2020,Nelson Marlborough,0,0,0,0,37,12,0,49
06/07/2020,Northland,0,0,0,0,26,2,0,28
06/07/2020,South Canterbury,0,0,0,0,15,2,0,17
06/07/2020,Southern,0,0,0,0,186,30,2,216
06/07/2020,Tairawhiti,0,0,0,0,3,1,0,4
06/07/2020,Taranaki,0,0,0,0,14,2,0,16
06/07/2020,Waikato,0,0,0,0,153,34,1,187
06/07/2020,Wairarapa,0,0,0,0,6,2,0,8
06/07/2020,Waitemata,0,0,0,0,166,71,4,237
06/07/2020,West Coast,0,0,0,0,4,1,1,5
06/07/2020,Whanganui,0,0,0,0,8,1,0,9
05/07/2020,Auckland,0,0,0,0,140,51,0,191
05/07/2020,Bay of Plenty,0,0,0,0,34,14,0,48
05/07/2020,Canterbury,3,0,0,3,104,65,12,169
05/07/2020,Capital and Coast,0,0,0,0,71,24,2,95
05/07/2020,Counties Manukau,0,0,0,0,117,23,0,140
05/07/2020,Hawke's Bay,0,0,0,0,38,6,0,44
05/07/2020,Hutt Valley,0,0,0,0,19,3,0,22
05/07/2020,Lakes,0,0,0,0,15,1,0,16
05/07/2020,Midcentral,0,0,0,0,27,5,0,32
05/07/2020,Nelson Marlborough,0,0,0,0,37,12,0,49
05/07/2020,Northland,0,0,0,0,26,2,0,28
05/07/2020,South Canterbury,0,0,0,0,15,2,0,17
05/07/2020,Southern,0,0,0,0,186,30,2,216
05/07/2020,Tairawhiti,0,0,0,0,3,1,0,4
05/07/2020,Taranaki,0,0,0,0,14,2,0,16
05/07/2020,Waikato,0,0,0,0,153,34,1,187
05/07/2020,Wairarapa,0,0,0,0,6,2,0,8
05/07/2020,Waitemata,0,0,0,0,166,71,4,237
05/07/2020,West Coast,0,0,0,0,4,1,1,5
05/07/2020,Whanganui,0,0,0,0,8,1,0,9
04/07/2020,Auckland,0,0,0,0,140,51,0,191
04/07/2020,Bay of Plenty,0,0,0,0,34,14,0,48
04/07/2020,Canterbury,0,0,0,0,101,65,12,166
04/07/2020,Capital and Coast,0,0,0,0,71,24,2,95
04/07/2020,Counties Manukau,0,0,0,0,117,23,0,140
04/07/2020,Hawke's Bay,0,0,0,0,38,6,0,44
04/07/2020,Hutt Valley,0,0,0,0,19,3,0,22
04/07/2020,Lakes,0,0,0,0,15,1,0,16
04/07/2020,Midcentral,0,0,0,0,27,5,0,32
04/07/2020,Nelson Marlborough,0,0,0,0,37,12,0,49
04/07/2020,Northland,0,0,0,0,26,2,0,28
04/07/2020,South Canterbury,0,0,0,0,15,2,0,17
04/07/2020,Southern,0,0,0,0,186,30,2,216
04/07/2020,Tairawhiti,0,0,0,0,3,1,0,4
04/07/2020,Taranaki,0,0,0,0,14,2,0,16
04/07/2020,Waikato,0,0,0,0,153,34,1,187
04/07/2020,Wairarapa,0,0,0,0,6,2,0,8
04/07/2020,Waitemata,0,0,0,0,166,71,4,237
04/07/2020,West Coast,0,0,0,0,4,1,1,5
04/07/2020,Whanganui,0,0,0,0,8,1,0,9
03/07/2020,Auckland,0,0,0,0,140,51,0,191
03/07/2020,Bay of Plenty,0,0,0,0,34,14,0,48
03/07/2020,Canterbury,0,0,0,0,101,65,12,166
03/07/2020,Capital and Coast,0,0,0,0,71,24,2,95
03/07/2020,Counties Manukau,0,0,0,0,117,23,0,140
03/07/2020,Hawke's Bay,0,0,0,0,38,6,0,44
03/07/2020,Hutt Valley,0,0,0,0,19,3,0,22
03/07/2020,Lakes,0,0,0,0,15,1,0,16
03/07/2020,Midcentral,0,0,0,0,27,5,0,32
03/07/2020,Nelson Marlborough,0,0,0,0,37,12,0,49
03/07/2020,Northland,0,0,0,0,26,2,0,28
03/07/2020,South Canterbury,0,0,0,0,15,2,0,17
03/07/2020,Southern,0,0,0,0,186,30,2,216
03/07/2020,Tairawhiti,0,0,0,0,3,1,0,4
03/07/2020,Taranaki,0,0,0,0,14,2,0,16
03/07/2020,Waikato,0,0,0,0,153,34,1,187
03/07/2020,Wairarapa,0,0,0,0,6,2,0,8
03/07/2020,Waitemata,0,0,0,0,166,71,4,237
03/07/2020,West Coast,0,0,0,0,4,1,1,5
03/07/2020,Whanganui,0,0,0,0,8,1,0,9
02/07/2020,Auckland,0,0,0,0,140,51,0,191
02/07/2020,Bay of Plenty,0,0,0,0,34,14,0,48
02/07/2020,Canterbury,0,0,0,0,101,65,12,166
02/07/2020,Capital and Coast,0,0,0,0,71,24,2,95
02/07/2020,Counties Manukau,1,0,0,1,117,23,0,140
02/07/2020,Hawke's Bay,0,0,0,0,38,6,0,44
02/07/2020,Hutt Valley,0,0,0,0,19,3,0,22
02/07/2020,Lakes,0,0,0,0,15,1,0,16
02/07/2020,Midcentral,0,0,0,0,27,5,0,32
02/07/2020,Nelson Marlborough,0,0,0,0,37,12,0,49
02/07/2020,Northland,0,0,0,0,26,2,0,28
02/07/2020,South Canterbury,0,0,0,0,15,2,0,17
02/07/2020,Southern,0,0,0,0,186,30,2,216
02/07/2020,Tairawhiti,0,0,0,0,3,1,0,4
02/07/2020,Taranaki,0,0,0,0,14,2,0,16
02/07/2020,Waikato,0,0,0,0,153,34,1,187
02/07/2020,Wairarapa,0,0,0,0,6,2,0,8
02/07/2020,Waitemata,0,0,0,0,166,71,4,237
02/07/2020,West Coast,0,0,0,0,4,1,1,5
02/07/2020,Whanganui,0,0,0,0,8,1,0,9
01/07/2020,Auckland,1,0,0,1,140,51,0,191
01/07/2020,Bay of Plenty,0,0,0,0,34,14,0,48
01/07/2020,Canterbury,0,0,0,0,101,65,12,166
01/07/2020,Capital and Coast,0,0,0,0,71,24,2,95
01/07/2020,Counties Manukau,0,0,0,0,116,23,0,139
01/07/2020,Hawke's Bay,0,0,0,0,38,6,0,44
01/07/2020,Hutt Valley,0,0,0,0,19,3,0,22
01/07/2020,Lakes,0,0,0,0,15,1,0,16
01/07/2020,Midcentral,0,0,0,0,27,5,0,32
01/07/2020,Nelson Marlborough,0,0,0,0,37,12,0,49
01/07/2020,Northland,0,0,0,0,26,2,0,28
01/07/2020,South Canterbury,0,0,0,0,15,2,0,17
01/07/2020,Southern,0,0,0,0,186,30,2,216
01/07/2020,Tairawhiti,0,0,0,0,3,1,0,4
01/07/2020,Taranaki,0,0,0,0,14,2,0,16
01/07/2020,Waikato,0,0,0,0,153,34,1,187
01/07/2020,Wairarapa,0,0,0,0,6,2,0,8
01/07/2020,Waitemata,0,0,0,0,166,71,4,237
01/07/2020,West Coast,0,0,0,0,4,1,1,5
01/07/2020,Whanganui,0,0,0,0,8,1,0,9
30/06/2020,Auckland,0,0,0,0,139,51,0,190
30/06/2020,Bay of Plenty,0,0,0,0,34,14,0,48
30/06/2020,Canterbury,0,0,0,0,101,65,12,166
30/06/2020,Capital and Coast,0,0,0,0,71,24,2,95
30/06/2020,Counties Manukau,0,0,0,0,116,23,0,139
30/06/2020,Hawke's Bay,0,0,0,0,38,6,0,44
30/06/2020,Hutt Valley,0,0,0,0,19,3,0,22
30/06/2020,Lakes,0,0,0,0,15,1,0,16
30/06/2020,Midcentral,0,0,0,0,27,5,0,32
30/06/2020,Nelson Marlborough,0,0,0,0,37,12,0,49
30/06/2020,Northland,0,0,0,0,26,2,0,28
30/06/2020,South Canterbury,0,0,0,0,15,2,0,17
30/06/2020,Southern,0,0,0,0,186,30,2,216
30/06/2020,Tairawhiti,0,0,0,0,3,1,0,4
30/06/2020,Taranaki,0,0,0,0,14,2,0,16
30/06/2020,Waikato,0,0,0,0,153,34,1,187
30/06/2020,Wairarapa,0,0,0,0,6,2,0,8
30/06/2020,Waitemata,0,0,0,0,166,71,4,237
30/06/2020,West Coast,0,0,0,0,4,1,1,5
30/06/2020,Whanganui,0,0,0,0,8,1,0,9
29/06/2020,Auckland,0,0,0,0,139,51,0,190
29/06/2020,Bay of Plenty,0,0,0,0,34,14,0,48
29/06/2020,Canterbury,0,0,0,0,101,65,12,166
29/06/2020,Capital and Coast,0,0,0,0,71,24,2,95
29/06/2020,Counties Manukau,1,0,0,1,116,23,0,139
29/06/2020,Hawke's Bay,0,0,0,0,38,6,0,44
29/06/2020,Hutt Valley,0,0,0,0,19,3,0,22
29/06/2020,Lakes,0,0,0,0,15,1,0,16
29/06/2020,Midcentral,0,0,0,0,27,5,0,32
29/06/2020,Nelson Marlborough,0,0,0,0,37,12,0,49
29/06/2020,Northland,0,0,0,0,26,2,0,28
29/06/2020,South Canterbury,0,0,0,0,15,2,0,17
29/06/2020,Southern,0,0,0,0,186,30,2,216
29/06/2020,Tairawhiti,0,0,0,0,3,1,0,4
29/06/2020,Taranaki,0,0,0,0,14,2,0,16
29/06/2020,Waikato,0,0,0,0,153,34,1,187
29/06/2020,Wairarapa,0,0,0,0,6,2,0,8
29/06/2020,Waitemata,0,0,0,0,166,71,4,237
29/06/2020,West Coast,0,0,0,0,4,1,1,5
29/06/2020,Whanganui,0,0,0,0,8,1,0,9
28/06/2020,Auckland,1,0,0,1,139,51,0,190
28/06/2020,Bay of Plenty,0,0,0,0,34,14,0,48
28/06/2020,Canterbury,0,0,0,0,101,65,12,166
28/06/2020,Capital and Coast,0,0,0,0,71,24,2,95
28/06/2020,Counties Manukau,0,0,0,0,115,23,0,138
28/06/2020,Hawke's Bay,0,0,0,0,38,6,0,44
28/06/2020,Hutt Valley,0,0,0,0,19,3,0,22
28/06/2020,Lakes,0,0,0,0,15,1,0,16
28/06/2020,Midcentral,0,0,0,0,27,5,0,32
28/06/2020,Nelson Marlborough,0,0,0,0,37,12,0,49
28/06/2020,Northland,0,0,0,0,26,2,0,28
28/06/2020,South Canterbury,0,0,0,0,15,2,0,17
28/06/2020,Southern,0,0,0,0,186,30,2,216
28/06/2020,Tairawhiti,0,0,0,0,3,1,0,4
28/06/2020,Taranaki,0,0,0,0,14,2,0,16
28/06/2020,Waikato,0,0,0,0,153,34,1,187
28/06/2020,Wairarapa,0,0,0,0,6,2,0,8
28/06/2020,Waitemata,0,0,0,0,166,71,4,237
28/06/2020,West Coast,0,0,0,0,4,1,1,5
28/06/2020,Whanganui,0,0,0,0,8,1,0,9
27/06/2020,Auckland,4,0,0,4,138,51,0,189
27/06/2020,Bay of Plenty,0,0,0,0,34,14,0,48
27/06/2020,Canterbury,0,0,0,0,101,65,12,166
27/06/2020,Capital and Coast,0,0,0,0,71,24,2,95
27/06/2020,Counties Manukau,1,0,0,1,115,23,0,138
27/06/2020,Hawke's Bay,0,0,0,0,38,6,0,44
27/06/2020,Hutt Valley,0,0,0,0,19,3,0,22
27/06/2020,Lakes,0,0,0,0,15,1,0,16
27/06/2020,Midcentral,0,0,0,0,27,5,0,32
27/06/2020,Nelson Marlborough,0,0,0,0,37,12,0,49
27/06/2020,Northland,0,0,0,0,26,2,0,28
27/06/2020,South Canterbury,0,0,0,0,15,2,0,17
27/06/2020,Southern,0,0,0,0,186,30,2,216
27/06/2020,Tairawhiti,0,0,0,0,3,1,0,4
27/06/2020,Taranaki,0,0,0,0,14,2,0,16
27/06/2020,Waikato,0,0,0,0,153,34,1,187
27/06/2020,Wairarapa,0,0,0,0,6,2,0,8
27/06/2020,Waitemata,0,0,0,0,166,71,4,237
27/06/2020,West Coast,0,0,0,0,4,1,1,5
27/06/2020,Whanganui,0,0,0,0,8,1,0,9
26/06/2020,Auckland,1,0,0,1,134,51,0,185
26/06/2020,Bay of Plenty,0,0,0,0,34,14,0,48
26/06/2020,Canterbury,0,0,0,0,101,65,12,166
26/06/2020,Capital and Coast,0,0,0,0,71,24,2,95
26/06/2020,Counties Manukau,0,0,0,0,114,23,0,137
26/06/2020,Hawke's Bay,0,0,0,0,38,6,0,44
26/06/2020,Hutt Valley,0,0,0,0,19,3,0,22
26/06/2020,Lakes,0,0,0,0,15,1,0,16
26/06/2020,Midcentral,0,0,0,0,27,5,0,32
26/06/2020,Nelson Marlborough,0,0,0,0,37,12,0,49
26/06/2020,Northland,0,0,0,0,26,2,0,28
26/06/2020,South Canterbury,0,0,0,0,15,2,0,17
26/06/2020,Southern,0,0,0,0,186,30,2,216
26/06/2020,Tairawhiti,0,0,0,0,3,1,0,4
26/06/2020,Taranaki,0,0,0,0,14,2,0,16
26/06/2020,Waikato,0,0,0,0,153,34,1,187
26/06/2020,Wairarapa,0,0,0,0,6,2,0,8
26/06/2020,Waitemata,0,0,0,0,166,71,4,237
26/06/2020,West Coast,0,0,0,0,4,1,1,5
26/06/2020,Whanganui,0,0,0,0,8,1,0,9
25/06/2020,Auckland,1,0,0,1,133,51,0,184
25/06/2020,Bay of Plenty,0,0,0,0,34,14,0,48
25/06/2020,Canterbury,0,0,0,0,101,65,12,166
25/06/2020,Capital and Coast,0,0,0,0,71,24,2,95
25/06/2020,Counties Manukau,0,0,0,0,114,23,0,137
25/06/2020,Hawke's Bay,0,0,0,0,38,6,0,44
25/06/2020,Hutt Valley,0,0,0,0,19,3,0,22
25/06/2020,Lakes,0,0,0,0,15,1,0,16
25/06/2020,Midcentral,0,0,0,0,27,5,0,32
25/06/2020,Nelson Marlborough,0,0,0,0,37,12,0,49
25/06/2020,Northland,0,0,0,0,26,2,0,28
25/06/2020,South Canterbury,0,0,0,0,15,2,0,17
25/06/2020,Southern,0,0,0,0,186,30,2,216
25/06/2020,Tairawhiti,0,0,0,0,3,1,0,4
25/06/2020,Taranaki,0,0,0,0,14,2,0,16
25/06/2020,Waikato,0,0,0,0,153,34,1,187
25/06/2020,Wairarapa,0,0,0,0,6,2,0,8
25/06/2020,Waitemata,0,0,0,0,166,71,4,237
25/06/2020,West Coast,0,0,0,0,4,1,1,5
25/06/2020,Whanganui,0,0,0,0,8,1,0,9
24/06/2020,Auckland,0,0,0,0,132,51,0,183
24/06/2020,Bay of Plenty,0,0,0,0,34,14,0,48
24/06/2020,Canterbury,2,0,0,2,101,65,12,166
24/06/2020,Capital and Coast,0,0,0,0,71,24,2,95
24/06/2020,Counties Manukau,1,0,0,1,114,23,0,137
24/06/2020,Hawke's Bay,0,0,0,0,38,6,0,44
24/06/2020,Hutt Valley,0,0,0,0,19,3,0,22
24/06/2020,Lakes,0,0,0,0,15,1,0,16
24/06/2020,Midcentral,0,0,0,0,27,5,0,32
24/06/2020,Nelson Marlborough,0,0,0,0,37,12,0,49
24/06/2020,Northland,0,0,0,0,26,2,0,28
24/06/2020,South Canterbury,0,0,0,0,15,2,0,17
24/06/2020,Southern,0,0,0,0,186,30,2,216
24/06/2020,Tairawhiti,0,0,0,0,3,1,0,4
24/06/2020,Taranaki,0,0,0,0,14,2,0,16
24/06/2020,Waikato,0,0,0,0,153,34,1,187
24/06/2020,Wairarapa,0,0,0,0,6,2,0,8
24/06/2020,Waitemata,0,0,0,0,166,71,4,237
24/06/2020,West Coast,0,0,0,0,4,1,1,5
24/06/2020,Whanganui,0,0,0,0,8,1,0,9
23/06/2020,Auckland,1,0,0,1,132,51,0,183
23/06/2020,Bay of Plenty,0,0,0,0,34,14,0,48
23/06/2020,Canterbury,0,0,0,0,99,65,12,164
23/06/2020,Capital and Coast,0,0,0,0,71,24,2,95
23/06/2020,Counties Manukau,0,0,0,0,113,23,0,136
23/06/2020,Hawke's Bay,0,0,0,0,38,6,0,44
23/06/2020,Hutt Valley,0,0,0,0,19,3,0,22
23/06/2020,Lakes,0,0,0,0,15,1,0,16
23/06/2020,Midcentral,0,0,0,0,27,5,0,32
23/06/2020,Nelson Marlborough,0,0,0,0,37,12,0,49
23/06/2020,Northland,0,0,0,0,26,2,0,28
23/06/2020,South Canterbury,0,0,0,0,15,2,0,17
23/06/2020,Southern,0,0,0,0,186,30,2,216
23/06/2020,Tairawhiti,0,0,0,0,3,1,0,4
23/06/2020,Taranaki,0,0,0,0,14,2,0,16
23/06/2020,Waikato,0,0,0,0,153,34,1,187
23/06/2020,Wairarapa,0,0,0,0,6,2,0,8
23/06/2020,Waitemata,0,0,0,0,166,71,4,237
23/06/2020,West Coast,0,0,0,0,4,1,1,5
23/06/2020,Whanganui,0,0,0,0,8,1,0,9
22/06/2020,Auckland,1,0,0,1,131,51,0,182
22/06/2020,Bay of Plenty,0,0,0,0,34,14,0,48
22/06/2020,Canterbury,0,0,0,0,99,65,12,164
22/06/2020,Capital and Coast,0,0,0,0,71,24,2,95
22/06/2020,Counties Manukau,1,0,0,1,113,23,0,136
22/06/2020,Hawke's Bay,0,0,0,0,38,6,0,44
22/06/2020,Hutt Valley,0,0,0,0,19,3,0,22
22/06/2020,Lakes,0,0,0,0,15,1,0,16
22/06/2020,Midcentral,0,0,0,0,27,5,0,32
22/06/2020,Nelson Marlborough,0,0,0,0,37,12,0,49
22/06/2020,Northland,0,0,0,0,26,2,0,28
22/06/2020,South Canterbury,0,0,0,0,15,2,0,17
22/06/2020,Southern,0,0,0,0,186,30,2,216
22/06/2020,Tairawhiti,0,0,0,0,3,1,0,4
22/06/2020,Taranaki,0,0,0,0,14,2,0,16
22/06/2020,Waikato,0,0,0,0,153,34,1,187
22/06/2020,Wairarapa,0,0,0,0,6,2,0,8
22/06/2020,Waitemata,0,0,0,0,166,71,4,237
22/06/2020,West Coast,0,0,0,0,4,1,1,5
22/06/2020,Whanganui,0,0,0,0,8,1,0,9
21/06/2020,Auckland,2,0,0,2,130,51,0,181
21/06/2020,Bay of Plenty,0,0,0,0,34,14,0,48
21/06/2020,Canterbury,0,0,0,0,99,65,12,164
21/06/2020,Capital and Coast,0,0,0,0,71,24,2,95
21/06/2020,Counties Manukau,1,0,0,1,112,23,0,135
21/06/2020,Hawke's Bay,0,0,0,0,38,6,0,44
21/06/2020,Hutt Valley,0,0,0,0,19,3,0,22
21/06/2020,Lakes,0,0,0,0,15,1,0,16
21/06/2020,Midcentral,0,0,0,0,27,5,0,32
21/06/2020,Nelson Marlborough,0,0,0,0,37,12,0,49
21/06/2020,Northland,0,0,0,0,26,2,0,28
21/06/2020,South Canterbury,0,0,0,0,15,2,0,17
21/06/2020,Southern,0,0,0,0,186,30,2,216
21/06/2020,Tairawhiti,0,0,0,0,3,1,0,4
21/06/2020,Taranaki,0,0,0,0,14,2,0,16
21/06/2020,Waikato,0,0,0,0,153,34,1,187
21/06/2020,Wairarapa,0,0,0,0,6,2,0,8
21/06/2020,Waitemata,0,0,0,0,166,71,4,237
21/06/2020,West Coast,0,0,0,0,4,1,1,5
21/06/2020,Whanganui,0,0,0,0,8,1,0,9
20/06/2020,Auckland,1,0,0,1,128,51,0,179
20/06/2020,Bay of Plenty,0,0,0,0,34,14,0,48
20/06/2020,Canterbury,0,0,0,0,99,65,12,164
20/06/2020,Capital and Coast,0,0,0,0,71,24,2,95
20/06/2020,Counties Manukau,0,0,0,0,111,23,0,134
20/06/2020,Hawke's Bay,0,0,0,0,38,6,0,44
20/06/2020,Hutt Valley,0,0,0,0,19,3,0,22
20/06/2020,Lakes,0,0,0,0,15,1,0,16
20/06/2020,Midcentral,0,0,0,0,27,5,0,32
20/06/2020,Nelson Marlborough,0,0,0,0,37,12,0,49
20/06/2020,Northland,0,0,0,0,26,2,0,28
20/06/2020,South Canterbury,0,0,0,0,15,2,0,17
20/06/2020,Southern,0,0,0,0,186,30,2,216
20/06/2020,Tairawhiti,0,0,0,0,3,1,0,4
20/06/2020,Taranaki,0,0,0,0,14,2,0,16
20/06/2020,Waikato,0,0,0,0,153,34,1,187
20/06/2020,Wairarapa,0,0,0,0,6,2,0,8
20/06/2020,Waitemata,0,0,0,0,166,71,4,237
20/06/2020,West Coast,0,0,0,0,4,1,1,5
20/06/2020,Whanganui,0,0,0,0,8,1,0,9
19/06/2020,Auckland,2,0,0,2,127,51,0,178
19/06/2020,Bay of Plenty,0,0,0,0,34,14,0,48
19/06/2020,Canterbury,0,0,0,0,99,65,12,164
19/06/2020,Capital and Coast,0,0,0,0,71,24,2,95
19/06/2020,Counties Manukau,0,0,0,0,111,23,0,134
19/06/2020,Hawke's Bay,0,0,0,0,38,6,0,44
19/06/2020,Hutt Valley,0,0,0,0,19,3,0,22
19/06/2020,Lakes,0,0,0,0,15,1,0,16
19/06/2020,Midcentral,0,0,0,0,27,5,0,32
19/06/2020,Nelson Marlborough,0,0,0,0,37,12,0,49
19/06/2020,Northland,0,0,0,0,26,2,0,28
19/06/2020,South Canterbury,0,0,0,0,15,2,0,17
19/06/2020,Southern,0,0,0,0,186,30,2,216
19/06/2020,Tairawhiti,0,0,0,0,3,1,0,4
19/06/2020,Taranaki,0,0,0,0,14,2,0,16
19/06/2020,Waikato,0,0,0,0,153,34,1,187
19/06/2020,Wairarapa,0,0,0,0,6,2,0,8
19/06/2020,Waitemata,0,0,0,0,166,71,4,237
19/06/2020,West Coast,0,0,0,0,4,1,1,5
19/06/2020,Whanganui,0,0,0,0,8,1,0,9
18/06/2020,Auckland,0,0,0,0,125,51,0,176
18/06/2020,Bay of Plenty,0,0,0,0,34,14,0,48
18/06/2020,Canterbury,0,0,0,0,99,65,12,164
18/06/2020,Capital and Coast,0,0,0,0,71,24,2,95
18/06/2020,Counties Manukau,0,0,0,0,111,23,0,134
18/06/2020,Hawke's Bay,0,0,0,0,38,6,0,44
18/06/2020,Hutt Valley,0,0,0,0,19,3,0,22
18/06/2020,Lakes,0,0,0,0,15,1,0,16
18/06/2020,Midcentral,0,0,0,0,27,5,0,32
18/06/2020,Nelson Marlborough,0,0,0,0,37,12,0,49
18/06/2020,Northland,0,0,0,0,26,2,0,28
18/06/2020,South Canterbury,0,0,0,0,15,2,0,17
18/06/2020,Southern,0,0,0,0,186,30,2,216
18/06/2020,Tairawhiti,0,0,0,0,3,1,0,4
18/06/2020,Taranaki,0,0,0,0,14,2,0,16
18/06/2020,Waikato,0,0,0,0,153,34,1,187
18/06/2020,Wairarapa,0,0,0,0,6,2,0,8
18/06/2020,Waitemata,0,0,0,0,166,71,4,237
18/06/2020,West Coast,0,0,0,0,4,1,1,5
18/06/2020,Whanganui,0,0,0,0,8,1,0,9
17/06/2020,Auckland,0,0,0,0,125,51,0,176
17/06/2020,Bay of Plenty,0,0,0,0,34,14,0,48
17/06/2020,Canterbury,0,0,0,0,99,65,12,164
17/06/2020,Capital and Coast,0,0,0,0,71,24,2,95
17/06/2020,Counties Manukau,1,0,0,1,111,23,0,134
17/06/2020,Hawke's Bay,0,0,0,0,38,6,0,44
17/06/2020,Hutt Valley,0,0,0,0,19,3,0,22
17/06/2020,Lakes,0,0,0,0,15,1,0,16
17/06/2020,Midcentral,0,0,0,0,27,5,0,32
17/06/2020,Nelson Marlborough,0,0,0,0,37,12,0,49
17/06/2020,Northland,0,0,0,0,26,2,0,28
17/06/2020,South Canterbury,0,0,0,0,15,2,0,17
17/06/2020,Southern,0,0,0,0,186,30,2,216
17/06/2020,Tairawhiti,0,0,0,0,3,1,0,4
17/06/2020,Taranaki,0,0,0,0,14,2,0,16
17/06/2020,Waikato,0,0,0,0,153,34,1,187
17/06/2020,Wairarapa,0,0,0,0,6,2,0,8
17/06/2020,Waitemata,0,0,0,0,166,71,4,237
17/06/2020,West Coast,0,0,0,0,4,1,1,5
17/06/2020,Whanganui,0,0,0,0,8,1,0,9
16/06/2020,Auckland,0,0,0,0,125,51,0,176
16/06/2020,Bay of Plenty,0,0,0,0,34,14,0,48
16/06/2020,Canterbury,0,0,0,0,99,65,12,164
16/06/2020,Capital and Coast,0,0,0,0,71,24,2,95
16/06/2020,Counties Manukau,0,0,0,0,110,23,0,133
16/06/2020,Hawke's Bay,0,0,0,0,38,6,0,44
16/06/2020,Hutt Valley,2,0,0,2,19,3,0,22
16/06/2020,Lakes,0,0,0,0,15,1,0,16
16/06/2020,Midcentral,0,0,0,0,27,5,0,32
16/06/2020,Nelson Marlborough,0,0,0,0,37,12,0,49
16/06/2020,Northland,0,0,0,0,26,2,0,28
16/06/2020,South Canterbury,0,0,0,0,15,2,0,17
16/06/2020,Southern,0,0,0,0,186,30,2,216
16/06/2020,Tairawhiti,0,0,0,0,3,1,0,4
16/06/2020,Taranaki,0,0,0,0,14,2,0,16
16/06/2020,Waikato,0,0,0,0,153,34,1,187
16/06/2020,Wairarapa,0,0,0,0,6,2,0,8
16/06/2020,Waitemata,0,0,0,0,166,71,4,237
16/06/2020,West Coast,0,0,0,0,4,1,1,5
16/06/2020,Whanganui,0,0,0,0,8,1,0,9
15/06/2020,Auckland,0,0,0,0,125,51,0,176
15/06/2020,Bay of Plenty,0,0,0,0,34,14,0,48
15/06/2020,Canterbury,0,0,0,0,99,65,12,164
15/06/2020,Capital and Coast,0,0,0,0,71,24,2,95
15/06/2020,Counties Manukau,0,0,0,0,110,23,0,133
15/06/2020,Hawke's Bay,0,0,0,0,38,6,0,44
15/06/2020,Hutt Valley,0,0,0,0,17,3,0,20
15/06/2020,Lakes,0,0,0,0,15,1,0,16
15/06/2020,Midcentral,0,0,0,0,27,5,0,32
15/06/2020,Nelson Marlborough,0,0,0,0,37,12,0,49
15/06/2020,Northland,0,0,0,0,26,2,0,28
15/06/2020,South Canterbury,0,0,0,0,15,2,0,17
15/06/2020,Southern,0,0,0,0,186,30,2,216
15/06/2020,Tairawhiti,0,0,0,0,3,1,0,4
15/06/2020,Taranaki,0,0,0,0,14,2,0,16
15/06/2020,Waikato,0,0,0,0,153,34,1,187
15/06/2020,Wairarapa,0,0,0,0,6,2,0,8
15/06/2020,Waitemata,0,0,0,0,166,71,4,237
15/06/2020,West Coast,0,0,0,0,4,1,1,5
15/06/2020,Whanganui,0,0,0,0,8,1,0,9
14/06/2020,Auckland,0,0,0,0,125,51,0,176
14/06/2020,Bay of Plenty,0,0,0,0,34,14,0,48
14/06/2020,Canterbury,0,0,0,0,99,65,12,164
14/06/2020,Capital and Coast,0,0,0,0,71,24,2,95
14/06/2020,Counties Manukau,0,0,0,0,110,23,0,133
14/06/2020,Hawke's Bay,0,0,0,0,38,6,0,44
14/06/2020,Hutt Valley,0,0,0,0,17,3,0,20
14/06/2020,Lakes,0,0,0,0,15,1,0,16
14/06/2020,Midcentral,0,0,0,0,27,5,0,32
14/06/2020,Nelson Marlborough,0,0,0,0,37,12,0,49
14/06/2020,Northland,0,0,0,0,26,2,0,28
14/06/2020,South Canterbury,0,0,0,0,15,2,0,17
14/06/2020,Southern,0,0,0,0,186,30,2,216
14/06/2020,Tairawhiti,0,0,0,0,3,1,0,4
14/06/2020,Taranaki,0,0,0,0,14,2,0,16
14/06/2020,Waikato,0,0,0,0,153,34,1,187
14/06/2020,Wairarapa,0,0,0,0,6,2,0,8
14/06/2020,Waitemata,0,0,0,0,166,71,4,237
14/06/2020,West Coast,0,0,0,0,4,1,1,5
14/06/2020,Whanganui,0,0,0,0,8,1,0,9
13/06/2020,Auckland,0,0,0,0,125,51,0,176
13/06/2020,Bay of Plenty,0,0,0,0,34,14,0,48
13/06/2020,Canterbury,0,0,0,0,99,65,12,164
13/06/2020,Capital and Coast,0,0,0,0,71,24,2,95
13/06/2020,Counties Manukau,0,0,0,0,110,23,0,133
13/06/2020,Hawke's Bay,0,0,0,0,38,6,0,44
13/06/2020,Hutt Valley,0,0,0,0,17,3,0,20
13/06/2020,Lakes,0,0,0,0,15,1,0,16
13/06/2020,Midcentral,0,0,0,0,27,5,0,32
13/06/2020,Nelson Marlborough,0,0,0,0,37,12,0,49
13/06/2020,Northland,0,0,0,0,26,2,0,28
13/06/2020,South Canterbury,0,0,0,0,15,2,0,17
13/06/2020,Southern,0,0,0,0,186,30,2,216
13/06/2020,Tairawhiti,0,0,0,0,3,1,0,4
13/06/2020,Taranaki,0,0,0,0,14,2,0,16
13/06/2020,Waikato,0,0,0,0,153,34,1,187
13/06/2020,Wairarapa,0,0,0,0,6,2,0,8
13/06/2020,Waitemata,0,0,0,0,166,71,4,237
13/06/2020,West Coast,0,0,0,0,4,1,1,5
13/06/2020,Whanganui,0,0,0,0,8,1,0,9
12/06/2020,Auckland,0,0,0,0,125,51,0,176
12/06/2020,Bay of Plenty,0,0,0,0,34,14,0,48
12/06/2020,Canterbury,0,0,0,0,99,65,12,164
12/06/2020,Capital and Coast,0,0,0,0,71,24,2,95
12/06/2020,Counties Manukau,0,0,0,0,110,23,0,133
12/06/2020,Hawke's Bay,0,0,0,0,38,6,0,44
12/06/2020,Hutt Valley,0,0,0,0,17,3,0,20
12/06/2020,Lakes,0,0,0,0,15,1,0,16
12/06/2020,Midcentral,0,0,0,0,27,5,0,32
12/06/2020,Nelson Marlborough,0,0,0,0,37,12,0,49
12/06/2020,Northland,0,0,0,0,26,2,0,28
12/06/2020,South Canterbury,0,0,0,0,15,2,0,17
12/06/2020,Southern,0,0,0,0,186,30,2,216
12/06/2020,Tairawhiti,0,0,0,0,3,1,0,4
12/06/2020,Taranaki,0,0,0,0,14,2,0,16
12/06/2020,Waikato,0,0,0,0,153,34,1,187
12/06/2020,Wairarapa,0,0,0,0,6,2,0,8
12/06/2020,Waitemata,0,0,0,0,166,71,4,237
12/06/2020,West Coast,0,0,0,0,4,1,1,5
12/06/2020,Whanganui,0,0,0,0,8,1,0,9
11/06/2020,Auckland,0,0,0,0,125,51,0,176
11/06/2020,Bay of Plenty,0,0,0,0,34,14,0,48
11/06/2020,Canterbury,0,0,0,0,99,65,12,164
11/06/2020,Capital and Coast,0,0,0,0,71,24,2,95
11/06/2020,Counties Manukau,0,0,0,0,110,23,0,133
11/06/2020,Hawke's Bay,0,0,0,0,38,6,0,44
11/06/2020,Hutt Valley,0,0,0,0,17,3,0,20
11/06/2020,Lakes,0,0,0,0,15,1,0,16
11/06/2020,Midcentral,0,0,0,0,27,5,0,32
11/06/2020,Nelson Marlborough,0,0,0,0,37,12,0,49
11/06/2020,Northland,0,0,0,0,26,2,0,28
11/06/2020,South Canterbury,0,0,0,0,15,2,0,17
11/06/2020,Southern,0,0,0,0,186,30,2,216
11/06/2020,Tairawhiti,0,0,0,0,3,1,0,4
11/06/2020,Taranaki,0,0,0,0,14,2,0,16
11/06/2020,Waikato,0,0,0,0,153,34,1,187
11/06/2020,Wairarapa,0,0,0,0,6,2,0,8
11/06/2020,Waitemata,0,0,0,0,166,71,4,237
11/06/2020,West Coast,0,0,0,0,4,1,1,5
11/06/2020,Whanganui,0,0,0,0,8,1,0,9
10/06/2020,Auckland,0,0,0,0,125,51,0,176
10/06/2020,Bay of Plenty,0,0,0,0,34,14,0,48
10/06/2020,Canterbury,0,0,0,0,99,65,12,164
10/06/2020,Capital and Coast,0,0,0,0,71,24,2,95
10/06/2020,Counties Manukau,0,0,0,0,110,23,0,133
10/06/2020,Hawke's Bay,0,0,0,0,38,6,0,44
10/06/2020,Hutt Valley,0,0,0,0,17,3,0,20
10/06/2020,Lakes,0,0,0,0,15,1,0,16
10/06/2020,Midcentral,0,0,0,0,27,5,0,32
10/06/2020,Nelson Marlborough,0,0,0,0,37,12,0,49
10/06/2020,Northland,0,0,0,0,26,2,0,28
10/06/2020,South Canterbury,0,0,0,0,15,2,0,17
10/06/2020,Southern,0,0,0,0,186,30,2,216
10/06/2020,Tairawhiti,0,0,0,0,3,1,0,4
10/06/2020,Taranaki,0,0,0,0,14,2,0,16
10/06/2020,Waikato,0,0,0,0,153,34,1,187
10/06/2020,Wairarapa,0,0,0,0,6,2,0,8
10/06/2020,Waitemata,0,0,0,0,166,71,4,237
10/06/2020,West Coast,0,0,0,0,4,1,1,5
10/06/2020,Whanganui,0,0,0,0,8,1,0,9
09/06/2020,Auckland,0,0,0,0,125,51,0,176
09/06/2020,Bay of Plenty,0,0,0,0,34,14,0,48
09/06/2020,Canterbury,0,0,0,0,99,65,12,164
09/06/2020,Capital and Coast,0,0,0,0,71,24,2,95
09/06/2020,Counties Manukau,0,0,0,0,110,23,0,133
09/06/2020,Hawke's Bay,0,0,0,0,38,6,0,44
09/06/2020,Hutt Valley,0,0,0,0,17,3,0,20
09/06/2020,Lakes,0,0,0,0,15,1,0,16
09/06/2020,Midcentral,0,0,0,0,27,5,0,32
09/06/2020,Nelson Marlborough,0,0,0,0,37,12,0,49
09/06/2020,Northland,0,0,0,0,26,2,0,28
09/06/2020,South Canterbury,0,0,0,0,15,2,0,17
09/06/2020,Southern,0,0,0,0,186,30,2,216
09/06/2020,Tairawhiti,0,0,0,0,3,1,0,4
09/06/2020,Taranaki,0,0,0,0,14,2,0,16
09/06/2020,Waikato,0,0,0,0,153,34,1,187
09/06/2020,Wairarapa,0,0,0,0,6,2,0,8
09/06/2020,Waitemata,0,0,0,0,166,71,4,237
09/06/2020,West Coast,0,0,0,0,4,1,1,5
09/06/2020,Whanganui,0,0,0,0,8,1,0,9
08/06/2020,Auckland,0,0,0,0,125,51,0,176
08/06/2020,Bay of Plenty,0,0,0,0,34,14,0,48
08/06/2020,Canterbury,0,0,0,0,99,65,12,164
08/06/2020,Capital and Coast,0,0,0,0,71,24,2,95
08/06/2020,Counties Manukau,0,0,0,0,110,23,0,133
08/06/2020,Hawke's Bay,0,0,0,0,38,6,0,44
08/06/2020,Hutt Valley,0,0,0,0,17,3,0,20
08/06/2020,Lakes,0,0,0,0,15,1,0,16
08/06/2020,Midcentral,0,0,0,0,27,5,0,32
08/06/2020,Nelson Marlborough,0,0,0,0,37,12,0,49
08/06/2020,Northland,0,0,0,0,26,2,0,28
08/06/2020,South Canterbury,0,0,0,0,15,2,0,17
08/06/2020,Southern,0,0,0,0,186,30,2,216
08/06/2020,Tairawhiti,0,0,0,0,3,1,0,4
08/06/2020,Taranaki,0,0,0,0,14,2,0,16
08/06/2020,Waikato,0,0,0,0,153,34,1,187
08/06/2020,Wairarapa,0,0,0,0,6,2,0,8
08/06/2020,Waitemata,0,0,0,0,166,71,4,237
08/06/2020,West Coast,0,0,0,0,4,1,1,5
08/06/2020,Whanganui,0,0,0,0,8,1,0,9
07/06/2020,Auckland,0,0,0,0,125,51,0,176
07/06/2020,Bay of Plenty,0,0,0,0,34,14,0,48
07/06/2020,Canterbury,0,0,0,0,99,65,12,164
07/06/2020,Capital and Coast,0,0,0,0,71,24,2,95
07/06/2020,Counties Manukau,0,0,0,0,110,23,0,133
07/06/2020,Hawke's Bay,0,0,0,0,38,6,0,44
07/06/2020,Hutt Valley,0,0,0,0,17,3,0,20
07/06/2020,Lakes,0,0,0,0,15,1,0,16
07/06/2020,Midcentral,0,0,0,0,27,5,0,32
07/06/2020,Nelson Marlborough,0,0,0,0,37,12,0,49
07/06/2020,Northland,0,0,0,0,26,2,0,28
07/06/2020,South Canterbury,0,0,0,0,15,2,0,17
07/06/2020,Southern,0,0,0,0,186,30,2,216
07/06/2020,Tairawhiti,0,0,0,0,3,1,0,4
07/06/2020,Taranaki,0,0,0,0,14,2,0,16
07/06/2020,Waikato,0,0,0,0,153,34,1,187
07/06/2020,Wairarapa,0,0,0,0,6,2,0,8
07/06/2020,Waitemata,0,0,0,0,166,71,4,237
07/06/2020,West Coast,0,0,0,0,4,1,1,5
07/06/2020,Whanganui,0,0,0,0,8,1,0,9
06/06/2020,Auckland,0,0,0,0,125,51,0,176
06/06/2020,Bay of Plenty,0,0,0,0,34,14,0,48
06/06/2020,Canterbury,0,0,0,0,99,65,12,164
06/06/2020,Capital and Coast,0,0,0,0,71,24,2,95
06/06/2020,Counties Manukau,0,0,0,0,110,23,0,133
06/06/2020,Hawke's Bay,0,0,0,0,38,6,0,44
06/06/2020,Hutt Valley,0,0,0,0,17,3,0,20
06/06/2020,Lakes,0,0,0,0,15,1,0,16
06/06/2020,Midcentral,0,0,0,0,27,5,0,32
06/06/2020,Nelson Marlborough,0,0,0,0,37,12,0,49
06/06/2020,Northland,0,0,0,0,26,2,0,28
06/06/2020,South Canterbury,0,0,0,0,15,2,0,17
06/06/2020,Southern,0,0,0,0,186,30,2,216
06/06/2020,Tairawhiti,0,0,0,0,3,1,0,4
06/06/2020,Taranaki,0,0,0,0,14,2,0,16
06/06/2020,Waikato,0,0,0,0,153,34,1,187
06/06/2020,Wairarapa,0,0,0,0,6,2,0,8
06/06/2020,Waitemata,0,0,0,0,166,71,4,237
06/06/2020,West Coast,0,0,0,0,4,1,1,5
06/06/2020,Whanganui,0,0,0,0,8,1,0,9
05/06/2020,Auckland,0,0,0,0,125,51,0,176
05/06/2020,Bay of Plenty,0,0,0,0,34,14,0,48
05/06/2020,Canterbury,0,0,0,0,99,65,12,164
05/06/2020,Capital and Coast,0,0,0,0,71,24,2,95
05/06/2020,Counties Manukau,0,0,0,0,110,23,0,133
05/06/2020,Hawke's Bay,0,0,0,0,38,6,0,44
05/06/2020,Hutt Valley,0,0,0,0,17,3,0,20
05/06/2020,Lakes,0,0,0,0,15,1,0,16
05/06/2020,Midcentral,0,0,0,0,27,5,0,32
05/06/2020,Nelson Marlborough,0,0,0,0,37,12,0,49
05/06/2020,Northland,0,0,0,0,26,2,0,28
05/06/2020,South Canterbury,0,0,0,0,15,2,0,17
05/06/2020,Southern,0,0,0,0,186,30,2,216
05/06/2020,Tairawhiti,0,0,0,0,3,1,0,4
05/06/2020,Taranaki,0,0,0,0,14,2,0,16
05/06/2020,Waikato,0,0,0,0,153,34,1,187
05/06/2020,Wairarapa,0,0,0,0,6,2,0,8
05/06/2020,Waitemata,0,0,0,0,166,71,4,237
05/06/2020,West Coast,0,0,0,0,4,1,1,5
05/06/2020,Whanganui,0,0,0,0,8,1,0,9
04/06/2020,Auckland,0,0,0,0,125,51,0,176
04/06/2020,Bay of Plenty,0,0,0,0,34,14,0,48
04/06/2020,Canterbury,0,0,0,0,99,65,12,164
04/06/2020,Capital and Coast,0,0,0,0,71,24,2,95
04/06/2020,Counties Manukau,0,0,0,0,110,23,0,133
04/06/2020,Hawke's Bay,0,0,0,0,38,6,0,44
04/06/2020,Hutt Valley,0,0,0,0,17,3,0,20
04/06/2020,Lakes,0,0,0,0,15,1,0,16
04/06/2020,Midcentral,0,0,0,0,27,5,0,32
04/06/2020,Nelson Marlborough,0,0,0,0,37,12,0,49
04/06/2020,Northland,0,0,0,0,26,2,0,28
04/06/2020,South Canterbury,0,0,0,0,15,2,0,17
04/06/2020,Southern,0,0,0,0,186,30,2,216
04/06/2020,Tairawhiti,0,0,0,0,3,1,0,4
04/06/2020,Taranaki,0,0,0,0,14,2,0,16
04/06/2020,Waikato,0,0,0,0,153,34,1,187
04/06/2020,Wairarapa,0,0,0,0,6,2,0,8
04/06/2020,Waitemata,0,0,0,0,166,71,4,237
04/06/2020,West Coast,0,0,0,0,4,1,1,5
04/06/2020,Whanganui,0,0,0,0,8,1,0,9
03/06/2020,Auckland,0,0,0,0,125,51,0,176
03/06/2020,Bay of Plenty,0,0,0,0,34,14,0,48
03/06/2020,Canterbury,0,0,0,0,99,65,12,164
03/06/2020,Capital and Coast,0,0,0,0,71,24,2,95
03/06/2020,Counties Manukau,0,0,0,0,110,23,0,133
03/06/2020,Hawke's Bay,0,0,0,0,38,6,0,44
03/06/2020,Hutt Valley,0,0,0,0,17,3,0,20
03/06/2020,Lakes,0,0,0,0,15,1,0,16
03/06/2020,Midcentral,0,0,0,0,27,5,0,32
03/06/2020,Nelson Marlborough,0,0,0,0,37,12,0,49
03/06/2020,Northland,0,0,0,0,26,2,0,28
03/06/2020,South Canterbury,0,0,0,0,15,2,0,17
03/06/2020,Southern,0,0,0,0,186,30,2,216
03/06/2020,Tairawhiti,0,0,0,0,3,1,0,4
03/06/2020,Taranaki,0,0,0,0,14,2,0,16
03/06/2020,Waikato,0,0,0,0,153,34,1,187
03/06/2020,Wairarapa,0,0,0,0,6,2,0,8
03/06/2020,Waitemata,0,0,0,0,166,71,4,237
03/06/2020,West Coast,0,0,0,0,4,1,1,5
03/06/2020,Whanganui,0,0,0,0,8,1,0,9
02/06/2020,Auckland,0,0,0,0,125,51,0,176
02/06/2020,Bay of Plenty,0,0,0,0,34,14,0,48
02/06/2020,Canterbury,0,0,0,0,99,65,12,164
02/06/2020,Capital and Coast,0,0,0,0,71,24,2,95
02/06/2020,Counties Manukau,0,0,0,0,110,23,0,133
02/06/2020,Hawke's Bay,0,0,0,0,38,6,0,44
02/06/2020,Hutt Valley,0,0,0,0,17,3,0,20
02/06/2020,Lakes,0,0,0,0,15,1,0,16
02/06/2020,Midcentral,0,0,0,0,27,5,0,32
02/06/2020,Nelson Marlborough,0,0,0,0,37,12,0,49
02/06/2020,Northland,0,0,0,0,26,2,0,28
02/06/2020,South Canterbury,0,0,0,0,15,2,0,17
02/06/2020,Southern,0,0,0,0,186,30,2,216
02/06/2020,Tairawhiti,0,0,0,0,3,1,0,4
02/06/2020,Taranaki,0,0,0,0,14,2,0,16
02/06/2020,Waikato,0,0,0,0,153,34,1,187
02/06/2020,Wairarapa,0,0,0,0,6,2,0,8
02/06/2020,Waitemata,0,0,0,0,166,71,4,237
02/06/2020,West Coast,0,0,0,0,4,1,1,5
02/06/2020,Whanganui,0,0,0,0,8,1,0,9
01/06/2020,Auckland,0,0,0,0,125,51,0,176
01/06/2020,Bay of Plenty,0,0,0,0,34,14,0,48
01/06/2020,Canterbury,0,0,0,0,99,65,12,164
01/06/2020,Capital and Coast,0,0,0,0,71,24,2,95
01/06/2020,Counties Manukau,0,0,0,0,110,23,0,133
01/06/2020,Hawke's Bay,0,0,0,0,38,6,0,44
01/06/2020,Hutt Valley,0,0,0,0,17,3,0,20
01/06/2020,Lakes,0,0,0,0,15,1,0,16
01/06/2020,Midcentral,0,0,0,0,27,5,0,32
01/06/2020,Nelson Marlborough,0,0,0,0,37,12,0,49
01/06/2020,Northland,0,0,0,0,26,2,0,28
01/06/2020,South Canterbury,0,0,0,0,15,2,0,17
01/06/2020,Southern,0,0,0,0,186,30,2,216
01/06/2020,Tairawhiti,0,0,0,0,3,1,0,4
01/06/2020,Taranaki,0,0,0,0,14,2,0,16
01/06/2020,Waikato,0,0,0,0,153,34,1,187
01/06/2020,Wairarapa,0,0,0,0,6,2,0,8
01/06/2020,Waitemata,0,0,0,0,166,71,4,237
01/06/2020,West Coast,0,0,0,0,4,1,1,5
01/06/2020,Whanganui,0,0,0,0,8,1,0,9
31/05/2020,Auckland,0,0,0,0,125,51,0,176
31/05/2020,Bay of Plenty,0,0,0,0,34,14,0,48
31/05/2020,Canterbury,0,0,0,0,99,65,12,164
31/05/2020,Capital and Coast,0,0,0,0,71,24,2,95
31/05/2020,Counties Manukau,0,0,0,0,110,23,0,133
31/05/2020,Hawke's Bay,0,0,0,0,38,6,0,44
31/05/2020,Hutt Valley,0,0,0,0,17,3,0,20
31/05/2020,Lakes,0,0,0,0,15,1,0,16
31/05/2020,Midcentral,0,0,0,0,27,5,0,32
31/05/2020,Nelson Marlborough,0,0,0,0,37,12,0,49
31/05/2020,Northland,0,0,0,0,26,2,0,28
31/05/2020,South Canterbury,0,0,0,0,15,2,0,17
31/05/2020,Southern,0,0,0,0,186,30,2,216
31/05/2020,Tairawhiti,0,0,0,0,3,1,0,4
31/05/2020,Taranaki,0,0,0,0,14,2,0,16
31/05/2020,Waikato,0,0,0,0,153,34,1,187
31/05/2020,Wairarapa,0,0,0,0,6,2,0,8
31/05/2020,Waitemata,0,0,0,0,166,71,4,237
31/05/2020,West Coast,0,0,0,0,4,1,1,5
31/05/2020,Whanganui,0,0,0,0,8,1,0,9
30/05/2020,Auckland,0,0,0,0,125,51,0,176
30/05/2020,Bay of Plenty,0,0,0,0,34,14,0,48
30/05/2020,Canterbury,0,0,0,0,99,65,12,164
30/05/2020,Capital and Coast,0,0,0,0,71,24,2,95
30/05/2020,Counties Manukau,0,0,0,0,110,23,0,133
30/05/2020,Hawke's Bay,0,0,0,0,38,6,0,44
30/05/2020,Hutt Valley,0,0,0,0,17,3,0,20
30/05/2020,Lakes,0,0,0,0,15,1,0,16
30/05/2020,Midcentral,0,0,0,0,27,5,0,32
30/05/2020,Nelson Marlborough,0,0,0,0,37,12,0,49
30/05/2020,Northland,0,0,0,0,26,2,0,28
30/05/2020,South Canterbury,0,0,0,0,15,2,0,17
30/05/2020,Southern,0,0,0,0,186,30,2,216
30/05/2020,Tairawhiti,0,0,0,0,3,1,0,4
30/05/2020,Taranaki,0,0,0,0,14,2,0,16
30/05/2020,Waikato,0,0,0,0,153,34,1,187
30/05/2020,Wairarapa,0,0,0,0,6,2,0,8
30/05/2020,Waitemata,0,0,0,0,166,71,4,237
30/05/2020,West Coast,0,0,0,0,4,1,1,5
30/05/2020,Whanganui,0,0,0,0,8,1,0,9
29/05/2020,Auckland,0,0,0,0,125,51,0,176
29/05/2020,Bay of Plenty,0,0,0,0,34,14,0,48
29/05/2020,Canterbury,0,0,0,0,99,65,12,164
29/05/2020,Capital and Coast,0,0,0,0,71,24,2,95
29/05/2020,Counties Manukau,0,0,0,0,110,23,0,133
29/05/2020,Hawke's Bay,0,0,0,0,38,6,0,44
29/05/2020,Hutt Valley,0,0,0,0,17,3,0,20
29/05/2020,Lakes,0,0,0,0,15,1,0,16
29/05/2020,Midcentral,0,0,0,0,27,5,0,32
29/05/2020,Nelson Marlborough,0,0,0,0,37,12,0,49
29/05/2020,Northland,0,0,0,0,26,2,0,28
29/05/2020,South Canterbury,0,0,0,0,15,2,0,17
29/05/2020,Southern,0,0,0,0,186,30,2,216
29/05/2020,Tairawhiti,0,0,0,0,3,1,0,4
29/05/2020,Taranaki,0,0,0,0,14,2,0,16
29/05/2020,Waikato,0,0,0,0,153,34,1,187
29/05/2020,Wairarapa,0,0,0,0,6,2,0,8
29/05/2020,Waitemata,0,0,0,0,166,71,4,237
29/05/2020,West Coast,0,0,0,0,4,1,1,5
29/05/2020,Whanganui,0,0,0,0,8,1,0,9
28/05/2020,Auckland,0,0,0,0,125,51,0,176
28/05/2020,Bay of Plenty,0,0,0,0,34,14,0,48
28/05/2020,Canterbury,0,0,0,0,99,65,12,164
28/05/2020,Capital and Coast,0,0,0,0,71,24,2,95
28/05/2020,Counties Manukau,0,0,0,0,110,23,0,133
28/05/2020,Hawke's Bay,0,0,0,0,38,6,0,44
28/05/2020,Hutt Valley,0,0,0,0,17,3,0,20
28/05/2020,Lakes,0,0,0,0,15,1,0,16
28/05/2020,Midcentral,0,0,0,0,27,5,0,32
28/05/2020,Nelson Marlborough,0,0,0,0,37,12,0,49
28/05/2020,Northland,0,0,0,0,26,2,0,28
28/05/2020,South Canterbury,0,0,0,0,15,2,0,17
28/05/2020,Southern,0,0,0,0,186,30,2,216
28/05/2020,Tairawhiti,0,0,0,0,3,1,0,4
28/05/2020,Taranaki,0,0,0,0,14,2,0,16
28/05/2020,Waikato,0,0,0,0,153,34,1,187
28/05/2020,Wairarapa,0,0,0,0,6,2,0,8
28/05/2020,Waitemata,0,0,0,0,166,71,4,237
28/05/2020,West Coast,0,0,0,0,4,1,1,5
28/05/2020,Whanganui,0,0,0,0,8,1,0,9
27/05/2020,Auckland,0,0,0,0,125,51,0,176
27/05/2020,Bay of Plenty,0,0,0,0,34,14,0,48
27/05/2020,Canterbury,0,0,0,0,99,65,12,164
27/05/2020,Capital and Coast,0,0,0,0,71,24,2,95
27/05/2020,Counties Manukau,0,0,0,0,110,23,0,133
27/05/2020,Hawke's Bay,0,0,0,0,38,6,0,44
27/05/2020,Hutt Valley,0,0,0,0,17,3,0,20
27/05/2020,Lakes,0,0,0,0,15,1,0,16
27/05/2020,Midcentral,0,0,0,0,27,5,0,32
27/05/2020,Nelson Marlborough,0,0,0,0,37,12,0,49
27/05/2020,Northland,0,0,0,0,26,2,0,28
27/05/2020,South Canterbury,0,0,0,0,15,2,0,17
27/05/2020,Southern,0,0,0,0,186,30,2,216
27/05/2020,Tairawhiti,0,0,0,0,3,1,0,4
27/05/2020,Taranaki,0,0,0,0,14,2,0,16
27/05/2020,Waikato,0,0,0,0,153,34,1,187
27/05/2020,Wairarapa,0,0,0,0,6,2,0,8
27/05/2020,Waitemata,0,0,0,0,166,71,4,237
27/05/2020,West Coast,0,0,0,0,4,1,1,5
27/05/2020,Whanganui,0,0,0,0,8,1,0,9
26/05/2020,Auckland,0,0,0,0,125,51,0,176
26/05/2020,Bay of Plenty,0,0,0,0,34,14,0,48
26/05/2020,Canterbury,0,0,0,0,99,65,12,164
26/05/2020,Capital and Coast,0,0,0,0,71,24,2,95
26/05/2020,Counties Manukau,0,0,0,0,110,23,0,133
26/05/2020,Hawke's Bay,0,0,0,0,38,6,0,44
26/05/2020,Hutt Valley,0,0,0,0,17,3,0,20
26/05/2020,Lakes,0,0,0,0,15,1,0,16
26/05/2020,Midcentral,0,0,0,0,27,5,0,32
26/05/2020,Nelson Marlborough,0,0,0,0,37,12,0,49
26/05/2020,Northland,0,0,0,0,26,2,0,28
26/05/2020,South Canterbury,0,0,0,0,15,2,0,17
26/05/2020,Southern,0,0,0,0,186,30,2,216
26/05/2020,Tairawhiti,0,0,0,0,3,1,0,4
26/05/2020,Taranaki,0,0,0,0,14,2,0,16
26/05/2020,Waikato,0,0,0,0,153,34,1,187
26/05/2020,Wairarapa,0,0,0,0,6,2,0,8
26/05/2020,Waitemata,0,0,0,0,166,71,4,237
26/05/2020,West Coast,0,0,0,0,4,1,1,5
26/05/2020,Whanganui,0,0,0,0,8,1,0,9
25/05/2020,Auckland,0,0,0,0,125,51,0,176
25/05/2020,Bay of Plenty,0,0,0,0,34,14,0,48
25/05/2020,Canterbury,0,0,0,0,99,65,12,164
25/05/2020,Capital and Coast,0,0,0,0,71,24,2,95
25/05/2020,Counties Manukau,0,0,0,0,110,23,0,133
25/05/2020,Hawke's Bay,0,0,0,0,38,6,0,44
25/05/2020,Hutt Valley,0,0,0,0,17,3,0,20
25/05/2020,Lakes,0,0,0,0,15,1,0,16
25/05/2020,Midcentral,0,0,0,0,27,5,0,32
25/05/2020,Nelson Marlborough,0,0,0,0,37,12,0,49
25/05/2020,Northland,0,0,0,0,26,2,0,28
25/05/2020,South Canterbury,0,0,0,0,15,2,0,17
25/05/2020,Southern,0,0,0,0,186,30,2,216
25/05/2020,Tairawhiti,0,0,0,0,3,1,0,4
25/05/2020,Taranaki,0,0,0,0,14,2,0,16
25/05/2020,Waikato,0,0,0,0,153,34,1,187
25/05/2020,Wairarapa,0,0,0,0,6,2,0,8
25/05/2020,Waitemata,0,0,0,0,166,71,4,237
25/05/2020,West Coast,0,0,0,0,4,1,1,5
25/05/2020,Whanganui,0,0,0,0,8,1,0,9
24/05/2020,Auckland,0,0,0,0,125,51,0,176
24/05/2020,Bay of Plenty,0,0,0,0,34,14,0,48
24/05/2020,Canterbury,0,0,0,0,99,65,12,164
24/05/2020,Capital and Coast,0,0,0,0,71,24,2,95
24/05/2020,Counties Manukau,0,0,0,0,110,23,0,133
24/05/2020,Hawke's Bay,0,0,0,0,38,6,0,44
24/05/2020,Hutt Valley,0,0,0,0,17,3,0,20
24/05/2020,Lakes,0,0,0,0,15,1,0,16
24/05/2020,Midcentral,0,0,0,0,27,5,0,32
24/05/2020,Nelson Marlborough,0,0,0,0,37,12,0,49
24/05/2020,Northland,0,0,0,0,26,2,0,28
24/05/2020,South Canterbury,0,0,0,0,15,2,0,17
24/05/2020,Southern,0,0,0,0,186,30,2,216
24/05/2020,Tairawhiti,0,0,0,0,3,1,0,4
24/05/2020,Taranaki,0,0,0,0,14,2,0,16
24/05/2020,Waikato,0,0,0,0,153,34,1,187
24/05/2020,Wairarapa,0,0,0,0,6,2,0,8
24/05/2020,Waitemata,0,0,1,0,166,71,4,237
24/05/2020,West Coast,0,0,0,0,4,1,1,5
24/05/2020,Whanganui,0,0,0,0,8,1,0,9
23/05/2020,Auckland,0,0,0,0,125,51,0,176
23/05/2020,Bay of Plenty,0,0,0,0,34,14,0,48
23/05/2020,Canterbury,0,0,0,0,99,65,12,164
23/05/2020,Capital and Coast,0,0,0,0,71,24,2,95
23/05/2020,Counties Manukau,0,0,0,0,110,23,0,133
23/05/2020,Hawke's Bay,0,0,0,0,38,6,0,44
23/05/2020,Hutt Valley,0,0,0,0,17,3,0,20
23/05/2020,Lakes,0,0,0,0,15,1,0,16
23/05/2020,Midcentral,0,0,0,0,27,5,0,32
23/05/2020,Nelson Marlborough,0,0,0,0,37,12,0,49
23/05/2020,Northland,0,0,0,0,26,2,0,28
23/05/2020,South Canterbury,0,0,0,0,15,2,0,17
23/05/2020,Southern,0,0,0,0,186,30,2,216
23/05/2020,Tairawhiti,0,0,0,0,3,1,0,4
23/05/2020,Taranaki,0,0,0,0,14,2,0,16
23/05/2020,Waikato,0,0,0,0,153,34,1,187
23/05/2020,Wairarapa,0,0,0,0,6,2,0,8
23/05/2020,Waitemata,0,0,0,0,166,71,3,237
23/05/2020,West Coast,0,0,0,0,4,1,1,5
23/05/2020,Whanganui,0,0,0,0,8,1,0,9
22/05/2020,Auckland,1,0,0,1,125,51,0,176
22/05/2020,Bay of Plenty,0,0,0,0,34,14,0,48
22/05/2020,Canterbury,0,0,0,0,99,65,12,164
22/05/2020,Capital and Coast,0,0,0,0,71,24,2,95
22/05/2020,Counties Manukau,0,0,0,0,110,23,0,133
22/05/2020,Hawke's Bay,0,0,0,0,38,6,0,44
22/05/2020,Hutt Valley,0,0,0,0,17,3,0,20
22/05/2020,Lakes,0,0,0,0,15,1,0,16
22/05/2020,Midcentral,0,0,0,0,27,5,0,32
22/05/2020,Nelson Marlborough,0,0,0,0,37,12,0,49
22/05/2020,Northland,0,0,0,0,26,2,0,28
22/05/2020,South Canterbury,0,0,0,0,15,2,0,17
22/05/2020,Southern,0,0,0,0,186,30,2,216
22/05/2020,Tairawhiti,0,0,0,0,3,1,0,4
22/05/2020,Taranaki,0,0,0,0,14,2,0,16
22/05/2020,Waikato,0,0,0,0,153,34,1,187
22/05/2020,Wairarapa,0,0,0,0,6,2,0,8
22/05/2020,Waitemata,0,0,0,0,166,71,3,237
22/05/2020,West Coast,0,0,0,0,4,1,1,5
22/05/2020,Whanganui,0,0,0,0,8,1,0,9
21/05/2020,Auckland,0,0,0,0,124,51,0,175
21/05/2020,Bay of Plenty,0,0,0,0,34,14,0,48
21/05/2020,Canterbury,0,0,0,0,99,65,12,164
21/05/2020,Capital and Coast,0,0,0,0,71,24,2,95
21/05/2020,Counties Manukau,0,0,0,0,110,23,0,133
21/05/2020,Hawke's Bay,0,0,0,0,38,6,0,44
21/05/2020,Hutt Valley,0,0,0,0,17,3,0,20
21/05/2020,Lakes,0,0,0,0,15,1,0,16
21/05/2020,Midcentral,0,0,0,0,27,5,0,32
21/05/2020,Nelson Marlborough,0,0,0,0,37,12,0,49
21/05/2020,Northland,0,0,0,0,26,2,0,28
21/05/2020,South Canterbury,0,0,0,0,15,2,0,17
21/05/2020,Southern,0,0,0,0,186,30,2,216
21/05/2020,Tairawhiti,0,0,0,0,3,1,0,4
21/05/2020,Taranaki,0,0,0,0,14,2,0,16
21/05/2020,Waikato,0,0,0,0,153,34,1,187
21/05/2020,Wairarapa,0,0,0,0,6,2,0,8
21/05/2020,Waitemata,0,0,0,0,166,71,3,237
21/05/2020,West Coast,0,0,0,0,4,1,1,5
21/05/2020,Whanganui,0,0,0,0,8,1,0,9
20/05/2020,Auckland,0,0,0,0,124,51,0,175
20/05/2020,Bay of Plenty,0,0,0,0,34,14,0,48
20/05/2020,Canterbury,0,0,0,0,99,65,12,164
20/05/2020,Capital and Coast,0,0,0,0,71,24,2,95
20/05/2020,Counties Manukau,0,0,0,0,110,23,0,133
20/05/2020,Hawke's Bay,0,0,0,0,38,6,0,44
20/05/2020,Hutt Valley,0,0,0,0,17,3,0,20
20/05/2020,Lakes,0,0,0,0,15,1,0,16
20/05/2020,Midcentral,0,0,0,0,27,5,0,32
20/05/2020,Nelson Marlborough,0,0,0,0,37,12,0,49
20/05/2020,Northland,0,0,0,0,26,2,0,28
20/05/2020,South Canterbury,0,0,0,0,15,2,0,17
20/05/2020,Southern,0,0,0,0,186,30,2,216
20/05/2020,Tairawhiti,0,0,0,0,3,1,0,4
20/05/2020,Taranaki,0,0,0,0,14,2,0,16
20/05/2020,Waikato,0,0,0,0,153,34,1,187
20/05/2020,Wairarapa,0,0,0,0,6,2,0,8
20/05/2020,Waitemata,0,0,0,0,166,71,3,237
20/05/2020,West Coast,0,0,0,0,4,1,1,5
20/05/2020,Whanganui,0,0,0,0,8,1,0,9
19/05/2020,Auckland,0,0,0,0,124,51,0,175
19/05/2020,Bay of Plenty,0,0,0,0,34,14,0,48
19/05/2020,Canterbury,0,0,0,0,99,65,12,164
19/05/2020,Capital and Coast,0,0,0,0,71,24,2,95
19/05/2020,Counties Manukau,0,0,0,0,110,23,0,133
19/05/2020,Hawke's Bay,0,0,0,0,38,6,0,44
19/05/2020,Hutt Valley,0,0,0,0,17,3,0,20
19/05/2020,Lakes,0,0,0,0,15,1,0,16
19/05/2020,Midcentral,0,0,0,0,27,5,0,32
19/05/2020,Nelson Marlborough,0,0,0,0,37,12,0,49
19/05/2020,Northland,0,0,0,0,26,2,0,28
19/05/2020,South Canterbury,0,0,0,0,15,2,0,17
19/05/2020,Southern,0,0,0,0,186,30,2,216
19/05/2020,Tairawhiti,0,0,0,0,3,1,0,4
19/05/2020,Taranaki,0,0,0,0,14,2,0,16
19/05/2020,Waikato,0,0,0,0,153,34,1,187
19/05/2020,Wairarapa,0,0,0,0,6,2,0,8
19/05/2020,Waitemata,0,0,0,0,166,71,3,237
19/05/2020,West Coast,0,0,0,0,4,1,1,5
19/05/2020,Whanganui,0,0,0,0,8,1,0,9
18/05/2020,Auckland,0,0,0,0,124,51,0,175
18/05/2020,Bay of Plenty,0,0,0,0,34,14,0,48
18/05/2020,Canterbury,0,0,0,0,99,65,12,164
18/05/2020,Capital and Coast,0,0,0,0,71,24,2,95
18/05/2020,Counties Manukau,0,0,0,0,110,23,0,133
18/05/2020,Hawke's Bay,0,0,0,0,38,6,0,44
18/05/2020,Hutt Valley,0,0,0,0,17,3,0,20
18/05/2020,Lakes,0,0,0,0,15,1,0,16
18/05/2020,Midcentral,0,0,0,0,27,5,0,32
18/05/2020,Nelson Marlborough,0,0,0,0,37,12,0,49
18/05/2020,Northland,0,0,0,0,26,2,0,28
18/05/2020,South Canterbury,0,0,0,0,15,2,0,17
18/05/2020,Southern,0,0,0,0,186,30,2,216
18/05/2020,Tairawhiti,0,0,0,0,3,1,0,4
18/05/2020,Taranaki,0,0,0,0,14,2,0,16
18/05/2020,Waikato,0,0,0,0,153,34,1,187
18/05/2020,Wairarapa,0,0,0,0,6,2,0,8
18/05/2020,Waitemata,0,0,0,0,166,71,3,237
18/05/2020,West Coast,0,0,0,0,4,1,1,5
18/05/2020,Whanganui,0,0,0,0,8,1,0,9
17/05/2020,Auckland,0,0,0,0,124,51,0,175
17/05/2020,Bay of Plenty,0,0,0,0,34,14,0,48
17/05/2020,Canterbury,0,0,0,0,99,65,12,164
17/05/2020,Capital and Coast,0,0,0,0,71,24,2,95
17/05/2020,Counties Manukau,0,0,0,0,110,23,0,133
17/05/2020,Hawke's Bay,0,0,0,0,38,6,0,44
17/05/2020,Hutt Valley,0,0,0,0,17,3,0,20
17/05/2020,Lakes,0,0,0,0,15,1,0,16
17/05/2020,Midcentral,0,0,0,0,27,5,0,32
17/05/2020,Nelson Marlborough,0,0,0,0,37,12,0,49
17/05/2020,Northland,0,0,0,0,26,2,0,28
17/05/2020,South Canterbury,0,0,0,0,15,2,0,17
17/05/2020,Southern,0,0,0,0,186,30,2,216
17/05/2020,Tairawhiti,0,0,0,0,3,1,0,4
17/05/2020,Taranaki,0,0,0,0,14,2,0,16
17/05/2020,Waikato,0,0,0,0,153,34,1,187
17/05/2020,Wairarapa,0,0,0,0,6,2,0,8
17/05/2020,Waitemata,0,0,0,0,166,71,3,237
17/05/2020,West Coast,0,0,0,0,4,1,1,5
17/05/2020,Whanganui,0,0,0,0,8,1,0,9
16/05/2020,Auckland,0,0,0,0,124,51,0,175
16/05/2020,Bay of Plenty,0,0,0,0,34,14,0,48
16/05/2020,Canterbury,0,0,0,0,99,65,12,164
16/05/2020,Capital and Coast,0,0,0,0,71,24,2,95
16/05/2020,Counties Manukau,0,0,0,0,110,23,0,133
16/05/2020,Hawke's Bay,0,0,0,0,38,6,0,44
16/05/2020,Hutt Valley,0,0,0,0,17,3,0,20
16/05/2020,Lakes,0,0,0,0,15,1,0,16
16/05/2020,Midcentral,0,0,0,0,27,5,0,32
16/05/2020,Nelson Marlborough,0,0,0,0,37,12,0,49
16/05/2020,Northland,0,0,0,0,26,2,0,28
16/05/2020,South Canterbury,0,0,0,0,15,2,0,17
16/05/2020,Southern,0,0,0,0,186,30,2,216
16/05/2020,Tairawhiti,0,0,0,0,3,1,0,4
16/05/2020,Taranaki,0,0,0,0,14,2,0,16
16/05/2020,Waikato,0,0,0,0,153,34,1,187
16/05/2020,Wairarapa,0,0,0,0,6,2,0,8
16/05/2020,Waitemata,0,0,0,0,166,71,3,237
16/05/2020,West Coast,0,0,0,0,4,1,1,5
16/05/2020,Whanganui,0,0,0,0,8,1,0,9
15/05/2020,Auckland,0,0,0,0,124,51,0,175
15/05/2020,Bay of Plenty,0,0,0,0,34,14,0,48
15/05/2020,Canterbury,1,0,0,1,99,65,12,164
15/05/2020,Capital and Coast,0,0,0,0,71,24,2,95
15/05/2020,Counties Manukau,0,0,0,0,110,23,0,133
15/05/2020,Hawke's Bay,0,0,0,0,38,6,0,44
15/05/2020,Hutt Valley,0,0,0,0,17,3,0,20
15/05/2020,Lakes,0,0,0,0,15,1,0,16
15/05/2020,Midcentral,0,0,0,0,27,5,0,32
15/05/2020,Nelson Marlborough,0,0,0,0,37,12,0,49
15/05/2020,Northland,0,0,0,0,26,2,0,28
15/05/2020,South Canterbury,0,0,0,0,15,2,0,17
15/05/2020,Southern,0,0,0,0,186,30,2,216
15/05/2020,Tairawhiti,0,0,0,0,3,1,0,4
15/05/2020,Taranaki,0,0,0,0,14,2,0,16
15/05/2020,Waikato,0,0,0,0,153,34,1,187
15/05/2020,Wairarapa,0,0,0,0,6,2,0,8
15/05/2020,Waitemata,0,0,0,0,166,71,3,237
15/05/2020,West Coast,0,0,0,0,4,1,1,5
15/05/2020,Whanganui,0,0,0,0,8,1,0,9
14/05/2020,Auckland,0,0,0,0,124,51,0,175
14/05/2020,Bay of Plenty,0,0,0,0,34,14,0,48
14/05/2020,Canterbury,0,0,0,0,98,65,12,163
14/05/2020,Capital and Coast,0,0,0,0,71,24,2,95
14/05/2020,Counties Manukau,0,0,0,0,110,23,0,133
14/05/2020,Hawke's Bay,0,0,0,0,38,6,0,44
14/05/2020,Hutt Valley,0,0,0,0,17,3,0,20
14/05/2020,Lakes,0,0,0,0,15,1,0,16
14/05/2020,Midcentral,0,0,0,0,27,5,0,32
14/05/2020,Nelson Marlborough,0,0,0,0,37,12,0,49
14/05/2020,Northland,0,0,0,0,26,2,0,28
14/05/2020,South Canterbury,0,0,0,0,15,2,0,17
14/05/2020,Southern,0,0,0,0,186,30,2,216
14/05/2020,Tairawhiti,0,0,0,0,3,1,0,4
14/05/2020,Taranaki,0,0,0,0,14,2,0,16
14/05/2020,Waikato,0,0,0,0,153,34,1,187
14/05/2020,Wairarapa,0,0,0,0,6,2,0,8
14/05/2020,Waitemata,1,0,0,1,166,71,3,237
14/05/2020,West Coast,0,0,0,0,4,1,1,5
14/05/2020,Whanganui,0,0,0,0,8,1,0,9
13/05/2020,Auckland,0,0,0,0,124,51,0,175
13/05/2020,Bay of Plenty,0,0,0,0,34,14,0,48
13/05/2020,Canterbury,0,0,0,0,98,65,12,163
13/05/2020,Capital and Coast,0,0,0,0,71,24,2,95
13/05/2020,Counties Manukau,0,0,0,0,110,23,0,133
13/05/2020,Hawke's Bay,0,0,0,0,38,6,0,44
13/05/2020,Hutt Valley,0,0,0,0,17,3,0,20
13/05/2020,Lakes,0,0,0,0,15,1,0,16
13/05/2020,Midcentral,0,0,0,0,27,5,0,32
13/05/2020,Nelson Marlborough,0,0,0,0,37,12,0,49
13/05/2020,Northland,0,0,0,0,26,2,0,28
13/05/2020,South Canterbury,0,0,0,0,15,2,0,17
13/05/2020,Southern,0,0,0,0,186,30,2,216
13/05/2020,Tairawhiti,0,0,0,0,3,1,0,4
13/05/2020,Taranaki,0,0,0,0,14,2,0,16
13/05/2020,Waikato,0,0,0,0,153,34,1,187
13/05/2020,Wairarapa,0,0,0,0,6,2,0,8
13/05/2020,Waitemata,0,0,0,0,165,71,3,236
13/05/2020,West Coast,0,0,0,0,4,1,1,5
13/05/2020,Whanganui,0,0,0,0,8,1,0,9
12/05/2020,Auckland,0,0,0,0,124,51,0,175
12/05/2020,Bay of Plenty,0,0,0,0,34,14,0,48
12/05/2020,Canterbury,0,0,0,0,98,65,12,163
12/05/2020,Capital and Coast,0,0,0,0,71,24,2,95
12/05/2020,Counties Manukau,0,0,0,0,110,23,0,133
12/05/2020,Hawke's Bay,0,0,0,0,38,6,0,44
12/05/2020,Hutt Valley,0,0,0,0,17,3,0,20
12/05/2020,Lakes,0,0,0,0,15,1,0,16
12/05/2020,Midcentral,0,0,0,0,27,5,0,32
12/05/2020,Nelson Marlborough,0,0,0,0,37,12,0,49
12/05/2020,Northland,0,0,0,0,26,2,0,28
12/05/2020,South Canterbury,0,0,0,0,15,2,0,17
12/05/2020,Southern,0,0,0,0,186,30,2,216
12/05/2020,Tairawhiti,0,0,0,0,3,1,0,4
12/05/2020,Taranaki,0,0,0,0,14,2,0,16
12/05/2020,Waikato,0,0,0,0,153,34,1,187
12/05/2020,Wairarapa,0,0,0,0,6,2,0,8
12/05/2020,Waitemata,0,0,0,0,165,71,3,236
12/05/2020,West Coast,0,0,0,0,4,1,1,5
12/05/2020,Whanganui,0,0,0,0,8,1,0,9
11/05/2020,Auckland,0,0,0,0,124,51,0,175
11/05/2020,Bay of Plenty,0,0,0,0,34,14,0,48
11/05/2020,Canterbury,0,0,0,0,98,65,12,163
11/05/2020,Capital and Coast,0,0,0,0,71,24,2,95
11/05/2020,Counties Manukau,0,0,0,0,110,23,0,133
11/05/2020,Hawke's Bay,0,0,0,0,38,6,0,44
11/05/2020,Hutt Valley,0,0,0,0,17,3,0,20
11/05/2020,Lakes,0,0,0,0,15,1,0,16
11/05/2020,Midcentral,0,0,0,0,27,5,0,32
11/05/2020,Nelson Marlborough,0,0,0,0,37,12,0,49
11/05/2020,Northland,0,0,0,0,26,2,0,28
11/05/2020,South Canterbury,0,0,0,0,15,2,0,17
11/05/2020,Southern,0,0,0,0,186,30,2,216
11/05/2020,Tairawhiti,0,0,0,0,3,1,0,4
11/05/2020,Taranaki,0,0,0,0,14,2,0,16
11/05/2020,Waikato,0,0,0,0,153,34,1,187
11/05/2020,Wairarapa,0,0,0,0,6,2,0,8
11/05/2020,Waitemata,0,0,0,0,165,71,3,236
11/05/2020,West Coast,0,0,0,0,4,1,1,5
11/05/2020,Whanganui,0,0,0,0,8,1,0,9
10/05/2020,Auckland,0,0,0,0,124,51,0,175
10/05/2020,Bay of Plenty,0,0,0,0,34,14,0,48
10/05/2020,Canterbury,0,0,0,0,98,65,12,163
10/05/2020,Capital and Coast,0,0,0,0,71,24,2,95
10/05/2020,Counties Manukau,0,0,0,0,110,23,0,133
10/05/2020,Hawke's Bay,0,0,0,0,38,6,0,44
10/05/2020,Hutt Valley,0,0,0,0,17,3,0,20
10/05/2020,Lakes,0,0,0,0,15,1,0,16
10/05/2020,Midcentral,0,0,0,0,27,5,0,32
10/05/2020,Nelson Marlborough,0,0,0,0,37,12,0,49
10/05/2020,Northland,0,0,0,0,26,2,0,28
10/05/2020,South Canterbury,0,0,0,0,15,2,0,17
10/05/2020,Southern,0,0,0,0,186,30,2,216
10/05/2020,Tairawhiti,0,0,0,0,3,1,0,4
10/05/2020,Taranaki,0,0,0,0,14,2,0,16
10/05/2020,Waikato,1,0,0,1,153,34,1,187
10/05/2020,Wairarapa,0,0,0,0,6,2,0,8
10/05/2020,Waitemata,2,0,0,2,165,71,3,236
10/05/2020,West Coast,0,0,0,0,4,1,1,5
10/05/2020,Whanganui,0,0,0,0,8,1,0,9
09/05/2020,Auckland,0,0,0,0,124,51,0,175
09/05/2020,Bay of Plenty,0,0,0,0,34,14,0,48
09/05/2020,Canterbury,0,0,0,0,98,65,12,163
09/05/2020,Capital and Coast,0,0,0,0,71,24,2,95
09/05/2020,Counties Manukau,0,0,0,0,110,23,0,133
09/05/2020,Hawke's Bay,0,0,0,0,38,6,0,44
09/05/2020,Hutt Valley,0,0,0,0,17,3,0,20
09/05/2020,Lakes,0,0,0,0,15,1,0,16
09/05/2020,Midcentral,1,0,0,1,27,5,0,32
09/05/2020,Nelson Marlborough,0,0,0,0,37,12,0,49
09/05/2020,Northland,0,0,0,0,26,2,0,28
09/05/2020,South Canterbury,0,0,0,0,15,2,0,17
09/05/2020,Southern,0,0,0,0,186,30,2,216
09/05/2020,Tairawhiti,0,0,0,0,3,1,0,4
09/05/2020,Taranaki,0,0,0,0,14,2,0,16
09/05/2020,Waikato,0,0,0,0,152,34,1,186
09/05/2020,Wairarapa,0,0,0,0,6,2,0,8
09/05/2020,Waitemata,0,0,0,0,163,71,3,234
09/05/2020,West Coast,0,0,0,0,4,1,1,5
09/05/2020,Whanganui,0,0,0,0,8,1,0,9
08/05/2020,Auckland,0,0,0,0,124,51,0,175
08/05/2020,Bay of Plenty,0,0,0,0,34,14,0,48
08/05/2020,Canterbury,0,0,0,0,98,65,12,163
08/05/2020,Capital and Coast,0,0,0,0,71,24,2,95
08/05/2020,Counties Manukau,0,0,0,0,110,23,0,133
08/05/2020,Hawke's Bay,0,0,0,0,38,6,0,44
08/05/2020,Hutt Valley,0,0,0,0,17,3,0,20
08/05/2020,Lakes,0,0,0,0,15,1,0,16
08/05/2020,Midcentral,0,0,0,0,26,5,0,31
08/05/2020,Nelson Marlborough,0,0,0,0,37,12,0,49
08/05/2020,Northland,0,0,0,0,26,2,0,28
08/05/2020,South Canterbury,0,0,0,0,15,2,0,17
08/05/2020,Southern,0,0,0,0,186,30,2,216
08/05/2020,Tairawhiti,0,0,0,0,3,1,0,4
08/05/2020,Taranaki,0,0,0,0,14,2,0,16
08/05/2020,Waikato,0,0,0,0,152,34,1,186
08/05/2020,Wairarapa,0,0,0,0,6,2,0,8
08/05/2020,Waitemata,0,1,0,1,163,71,3,234
08/05/2020,West Coast,0,0,0,0,4,1,1,5
08/05/2020,Whanganui,0,0,0,0,8,1,0,9
07/05/2020,Auckland,0,0,0,0,124,51,0,175
07/05/2020,Bay of Plenty,0,0,0,0,34,14,0,48
07/05/2020,Canterbury,0,0,0,0,98,65,12,163
07/05/2020,Capital and Coast,0,0,0,0,71,24,2,95
07/05/2020,Counties Manukau,0,0,0,0,110,23,0,133
07/05/2020,Hawke's Bay,0,0,0,0,38,6,0,44
07/05/2020,Hutt Valley,0,0,0,0,17,3,0,20
07/05/2020,Lakes,0,0,0,0,15,1,0,16
07/05/2020,Midcentral,0,0,0,0,26,5,0,31
07/05/2020,Nelson Marlborough,0,0,0,0,37,12,0,49
07/05/2020,Northland,0,0,0,0,26,2,0,28
07/05/2020,South Canterbury,0,0,0,0,15,2,0,17
07/05/2020,Southern,0,0,0,0,186,30,2,216
07/05/2020,Tairawhiti,0,0,0,0,3,1,0,4
07/05/2020,Taranaki,0,0,0,0,14,2,0,16
07/05/2020,Waikato,0,0,0,0,152,34,1,186
07/05/2020,Wairarapa,0,0,0,0,6,2,0,8
07/05/2020,Waitemata,1,0,0,1,163,70,3,233
07/05/2020,West Coast,0,0,0,0,4,1,1,5
07/05/2020,Whanganui,0,0,0,0,8,1,0,9
06/05/2020,Auckland,0,0,0,0,124,51,0,175
06/05/2020,Bay of Plenty,0,0,0,0,34,14,0,48
06/05/2020,Canterbury,0,0,0,0,98,65,12,163
06/05/2020,Capital and Coast,0,0,0,0,71,24,2,95
06/05/2020,Counties Manukau,0,0,0,0,110,23,0,133
06/05/2020,Hawke's Bay,0,0,0,0,38,6,0,44
06/05/2020,Hutt Valley,0,0,0,0,17,3,0,20
06/05/2020,Lakes,0,0,0,0,15,1,0,16
06/05/2020,Midcentral,0,0,0,0,26,5,0,31
06/05/2020,Nelson Marlborough,0,0,0,0,37,12,0,49
06/05/2020,Northland,0,0,0,0,26,2,0,28
06/05/2020,South Canterbury,0,0,0,0,15,2,0,17
06/05/2020,Southern,0,0,0,0,186,30,2,216
06/05/2020,Tairawhiti,0,0,0,0,3,1,0,4
06/05/2020,Taranaki,0,0,0,0,14,2,0,16
06/05/2020,Waikato,1,0,0,1,152,34,1,186
06/05/2020,Wairarapa,0,0,0,0,6,2,0,8
06/05/2020,Waitemata,1,0,0,1,162,70,3,232
06/05/2020,West Coast,0,0,0,0,4,1,1,5
06/05/2020,Whanganui,0,0,0,0,8,1,0,9
05/05/2020,Auckland,0,1,0,1,124,51,0,175
05/05/2020,Bay of Plenty,0,0,0,0,34,14,0,48
05/05/2020,Canterbury,0,0,1,0,98,65,12,163
05/05/2020,Capital and Coast,0,0,0,0,71,24,2,95
05/05/2020,Counties Manukau,0,0,0,0,110,23,0,133
05/05/2020,Hawke's Bay,0,0,0,0,38,6,0,44
05/05/2020,Hutt Valley,0,0,0,0,17,3,0,20
05/05/2020,Lakes,0,0,0,0,15,1,0,16
05/05/2020,Midcentral,0,0,0,0,26,5,0,31
05/05/2020,Nelson Marlborough,0,0,0,0,37,12,0,49
05/05/2020,Northland,0,0,0,0,26,2,0,28
05/05/2020,South Canterbury,0,0,0,0,15,2,0,17
05/05/2020,Southern,0,0,0,0,186,30,2,216
05/05/2020,Tairawhiti,0,0,0,0,3,1,0,4
05/05/2020,Taranaki,0,0,0,0,14,2,0,16
05/05/2020,Waikato,0,0,0,0,151,34,1,185
05/05/2020,Wairarapa,0,0,0,0,6,2,0,8
05/05/2020,Waitemata,1,0,0,1,161,70,3,231
05/05/2020,West Coast,0,0,0,0,4,1,1,5
05/05/2020,Whanganui,0,0,0,0,8,1,0,9
04/05/2020,Auckland,0,0,0,0,124,50,0,174
04/05/2020,Bay of Plenty,0,0,0,0,34,14,0,48
04/05/2020,Canterbury,0,0,0,0,98,65,11,163
04/05/2020,Capital and Coast,0,0,0,0,71,24,2,95
04/05/2020,Counties Manukau,0,0,0,0,110,23,0,133
04/05/2020,Hawke's Bay,0,0,0,0,38,6,0,44
04/05/2020,Hutt Valley,0,0,0,0,17,3,0,20
04/05/2020,Lakes,0,0,0,0,15,1,0,16
04/05/2020,Midcentral,0,0,0,0,26,5,0,31
04/05/2020,Nelson Marlborough,0,0,0,0,37,12,0,49
04/05/2020,Northland,0,0,0,0,26,2,0,28
04/05/2020,South Canterbury,0,0,0,0,15,2,0,17
04/05/2020,Southern,0,0,0,0,186,30,2,216
04/05/2020,Tairawhiti,0,0,0,0,3,1,0,4
04/05/2020,Taranaki,0,0,0,0,14,2,0,16
04/05/2020,Waikato,0,0,0,0,151,34,1,185
04/05/2020,Wairarapa,0,0,0,0,6,2,0,8
04/05/2020,Waitemata,0,0,0,0,160,70,3,230
04/05/2020,West Coast,0,0,0,0,4,1,1,5
04/05/2020,Whanganui,0,0,0,0,8,1,0,9
03/05/2020,Auckland,0,0,0,0,124,50,0,174
03/05/2020,Bay of Plenty,0,0,0,0,34,14,0,48
03/05/2020,Canterbury,0,0,0,0,98,65,11,163
03/05/2020,Capital and Coast,0,0,0,0,71,24,2,95
03/05/2020,Counties Manukau,1,0,0,1,110,23,0,133
03/05/2020,Hawke's Bay,0,0,0,0,38,6,0,44
03/05/2020,Hutt Valley,0,0,0,0,17,3,0,20
03/05/2020,Lakes,0,0,0,0,15,1,0,16
03/05/2020,Midcentral,0,0,0,0,26,5,0,31
03/05/2020,Nelson Marlborough,0,0,0,0,37,12,0,49
03/05/2020,Northland,0,0,0,0,26,2,0,28
03/05/2020,South Canterbury,0,0,0,0,15,2,0,17
03/05/2020,Southern,0,0,0,0,186,30,2,216
03/05/2020,Tairawhiti,0,0,0,0,3,1,0,4
03/05/2020,Taranaki,0,0,0,0,14,2,0,16
03/05/2020,Waikato,0,0,0,0,151,34,1,185
03/05/2020,Wairarapa,0,0,0,0,6,2,0,8
03/05/2020,Waitemata,0,0,0,0,160,70,3,230
03/05/2020,West Coast,0,0,0,0,4,1,1,5
03/05/2020,Whanganui,0,0,0,0,8,1,0,9
02/05/2020,Auckland,0,0,0,0,124,50,0,174
02/05/2020,Bay of Plenty,0,0,0,0,34,14,0,48
02/05/2020,Canterbury,0,0,1,0,98,65,11,163
02/05/2020,Capital and Coast,0,0,0,0,71,24,2,95
02/05/2020,Counties Manukau,0,0,0,0,109,23,0,132
02/05/2020,Hawke's Bay,0,0,0,0,38,6,0,44
02/05/2020,Hutt Valley,0,0,0,0,17,3,0,20
02/05/2020,Lakes,0,0,0,0,15,1,0,16
02/05/2020,Midcentral,0,0,0,0,26,5,0,31
02/05/2020,Nelson Marlborough,0,0,0,0,37,12,0,49
02/05/2020,Northland,0,0,0,0,26,2,0,28
02/05/2020,South Canterbury,0,0,0,0,15,2,0,17
02/05/2020,Southern,0,0,0,0,186,30,2,216
02/05/2020,Tairawhiti,0,0,0,0,3,1,0,4
02/05/2020,Taranaki,0,0,0,0,14,2,0,16
02/05/2020,Waikato,0,0,0,0,151,34,1,185
02/05/2020,Wairarapa,0,0,0,0,6,2,0,8
02/05/2020,Waitemata,0,0,0,0,160,70,3,230
02/05/2020,West Coast,0,0,0,0,4,1,1,5
02/05/2020,Whanganui,0,0,0,0,8,1,0,9
01/05/2020,Auckland,1,1,0,2,124,50,0,174
01/05/2020,Bay of Plenty,0,0,0,0,34,14,0,48
01/05/2020,Canterbury,1,0,0,1,98,65,10,163
01/05/2020,Capital and Coast,0,0,0,0,71,24,2,95
01/05/2020,Counties Manukau,0,0,0,0,109,23,0,132
01/05/2020,Hawke's Bay,0,0,0,0,38,6,0,44
01/05/2020,Hutt Valley,0,0,0,0,17,3,0,20
01/05/2020,Lakes,0,0,0,0,15,1,0,16
01/05/2020,Midcentral,0,0,0,0,26,5,0,31
01/05/2020,Nelson Marlborough,0,0,0,0,37,12,0,49
01/05/2020,Northland,0,0,0,0,26,2,0,28
01/05/2020,South Canterbury,0,0,0,0,15,2,0,17
01/05/2020,Southern,0,0,0,0,186,30,2,216
01/05/2020,Tairawhiti,0,0,0,0,3,1,0,4
01/05/2020,Taranaki,0,0,0,0,14,2,0,16
01/05/2020,Waikato,0,0,0,0,151,34,1,185
01/05/2020,Wairarapa,0,0,0,0,6,2,0,8
01/05/2020,Waitemata,1,1,0,2,160,70,3,230
01/05/2020,West Coast,0,0,0,0,4,1,1,5
01/05/2020,Whanganui,0,0,0,0,8,1,0,9
30/04/2020,Auckland,2,0,0,2,123,49,0,172
30/04/2020,Bay of Plenty,0,0,0,0,34,14,0,48
30/04/2020,Canterbury,0,0,0,0,97,65,10,162
30/04/2020,Capital and Coast,0,0,0,0,71,24,2,95
30/04/2020,Counties Manukau,0,0,0,0,109,23,0,132
30/04/2020,Hawke's Bay,0,0,0,0,38,6,0,44
30/04/2020,Hutt Valley,0,0,0,0,17,3,0,20
30/04/2020,Lakes,0,0,0,0,15,1,0,16
30/04/2020,Midcentral,0,0,0,0,26,5,0,31
30/04/2020,Nelson Marlborough,0,0,0,0,37,12,0,49
30/04/2020,Northland,0,0,0,0,26,2,0,28
30/04/2020,South Canterbury,0,0,0,0,15,2,0,17
30/04/2020,Southern,0,0,0,0,186,30,2,216
30/04/2020,Tairawhiti,0,0,0,0,3,1,0,4
30/04/2020,Taranaki,0,0,0,0,14,2,0,16
30/04/2020,Waikato,0,0,0,0,151,34,1,185
30/04/2020,Wairarapa,0,0,0,0,6,2,0,8
30/04/2020,Waitemata,1,0,0,1,159,69,3,228
30/04/2020,West Coast,0,0,0,0,4,1,1,5
30/04/2020,Whanganui,0,0,0,0,8,1,0,9
29/04/2020,Auckland,0,0,0,0,121,49,0,170
29/04/2020,Bay of Plenty,0,0,0,0,34,14,0,48
29/04/2020,Canterbury,0,0,0,0,97,65,10,162
29/04/2020,Capital and Coast,0,0,0,0,71,24,2,95
29/04/2020,Counties Manukau,1,0,0,1,109,23,0,132
29/04/2020,Hawke's Bay,0,0,0,0,38,6,0,44
29/04/2020,Hutt Valley,0,0,0,0,17,3,0,20
29/04/2020,Lakes,0,0,0,0,15,1,0,16
29/04/2020,Midcentral,0,0,0,0,26,5,0,31
29/04/2020,Nelson Marlborough,1,0,0,1,37,12,0,49
29/04/2020,Northland,0,0,0,0,26,2,0,28
29/04/2020,South Canterbury,0,0,0,0,15,2,0,17
29/04/2020,Southern,0,0,0,0,186,30,2,216
29/04/2020,Tairawhiti,0,0,0,0,3,1,0,4
29/04/2020,Taranaki,0,0,0,0,14,2,0,16
29/04/2020,Waikato,0,0,0,0,151,34,1,185
29/04/2020,Wairarapa,0,0,0,0,6,2,0,8
29/04/2020,Waitemata,0,0,0,0,158,69,3,227
29/04/2020,West Coast,0,0,0,0,4,1,1,5
29/04/2020,Whanganui,0,0,0,0,8,1,0,9
28/04/2020,Auckland,0,0,0,0,121,49,0,170
28/04/2020,Bay of Plenty,0,0,0,0,34,14,0,48
28/04/2020,Canterbury,0,0,0,0,97,65,10,162
28/04/2020,Capital and Coast,0,0,0,0,71,24,2,95
28/04/2020,Counties Manukau,1,0,0,1,108,23,0,131
28/04/2020,Hawke's Bay,0,0,0,0,38,6,0,44
28/04/2020,Hutt Valley,0,0,0,0,17,3,0,20
28/04/2020,Lakes,0,0,0,0,15,1,0,16
28/04/2020,Midcentral,0,0,0,0,26,5,0,31
28/04/2020,Nelson Marlborough,0,0,0,0,36,12,0,48
28/04/2020,Northland,0,0,0,0,26,2,0,28
28/04/2020,South Canterbury,0,0,0,0,15,2,0,17
28/04/2020,Southern,0,0,0,0,186,30,2,216
28/04/2020,Tairawhiti,0,0,0,0,3,1,0,4
28/04/2020,Taranaki,0,0,0,0,14,2,0,16
28/04/2020,Waikato,0,0,0,0,151,34,1,185
28/04/2020,Wairarapa,0,0,0,0,6,2,0,8
28/04/2020,Waitemata,0,0,0,0,158,69,3,227
28/04/2020,West Coast,0,0,0,0,4,1,1,5
28/04/2020,Whanganui,0,0,0,0,8,1,0,9
27/04/2020,Auckland,0,0,0,0,121,49,0,170
27/04/2020,Bay of Plenty,0,0,0,0,34,14,0,48
27/04/2020,Canterbury,0,0,0,0,97,65,10,162
27/04/2020,Capital and Coast,0,0,0,0,71,24,2,95
27/04/2020,Counties Manukau,0,0,0,0,107,23,0,130
27/04/2020,Hawke's Bay,1,0,0,1,38,6,0,44
27/04/2020,Hutt Valley,0,0,0,0,17,3,0,20
27/04/2020,Lakes,0,0,0,0,15,1,0,16
27/04/2020,Midcentral,0,0,0,0,26,5,0,31
27/04/2020,Nelson Marlborough,0,0,0,0,36,12,0,48
27/04/2020,Northland,0,0,0,0,26,2,0,28
27/04/2020,South Canterbury,0,0,0,0,15,2,0,17
27/04/2020,Southern,0,0,0,0,186,30,2,216
27/04/2020,Tairawhiti,0,0,0,0,3,1,0,4
27/04/2020,Taranaki,0,0,0,0,14,2,0,16
27/04/2020,Waikato,0,0,0,0,151,34,1,185
27/04/2020,Wairarapa,0,0,0,0,6,2,0,8
27/04/2020,Waitemata,2,0,0,2,158,69,3,227
27/04/2020,West Coast,0,0,0,0,4,1,1,5
27/04/2020,Whanganui,0,0,0,0,8,1,0,9
26/04/2020,Auckland,0,0,0,0,121,49,0,170
26/04/2020,Bay of Plenty,0,0,0,0,34,14,0,48
26/04/2020,Canterbury,0,0,0,0,97,65,10,162
26/04/2020,Capital and Coast,0,0,0,0,71,24,2,95
26/04/2020,Counties Manukau,0,0,0,0,107,23,0,130
26/04/2020,Hawke's Bay,1,0,0,1,37,6,0,43
26/04/2020,Hutt Valley,0,0,0,0,17,3,0,20
26/04/2020,Lakes,0,0,0,0,15,1,0,16
26/04/2020,Midcentral,0,0,0,0,26,5,0,31
26/04/2020,Nelson Marlborough,0,0,0,0,36,12,0,48
26/04/2020,Northland,0,0,0,0,26,2,0,28
26/04/2020,South Canterbury,0,0,0,0,15,2,0,17
26/04/2020,Southern,0,0,0,0,186,30,2,216
26/04/2020,Tairawhiti,0,0,0,0,3,1,0,4
26/04/2020,Taranaki,0,1,0,1,14,2,0,16
26/04/2020,Waikato,0,0,0,0,151,34,1,185
26/04/2020,Wairarapa,0,0,0,0,6,2,0,8
26/04/2020,Waitemata,1,0,1,1,156,69,3,225
26/04/2020,West Coast,0,0,0,0,4,1,1,5
26/04/2020,Whanganui,0,0,0,0,8,1,0,9
25/04/2020,Auckland,0,1,0,1,121,49,0,170
25/04/2020,Bay of Plenty,0,0,0,0,34,14,0,48
25/04/2020,Canterbury,0,0,0,0,97,65,10,162
25/04/2020,Capital and Coast,0,0,0,0,71,24,2,95
25/04/2020,Counties Manukau,0,0,0,0,107,23,0,130
25/04/2020,Hawke's Bay,0,0,0,0,36,6,0,42
25/04/2020,Hutt Valley,0,0,0,0,17,3,0,20
25/04/2020,Lakes,0,0,0,0,15,1,0,16
25/04/2020,Midcentral,0,0,0,0,26,5,0,31
25/04/2020,Nelson Marlborough,0,0,0,0,36,12,0,48
25/04/2020,Northland,0,0,0,0,26,2,0,28
25/04/2020,South Canterbury,0,1,0,1,15,2,0,17
25/04/2020,Southern,0,0,0,0,186,30,2,216
25/04/2020,Tairawhiti,0,0,0,0,3,1,0,4
25/04/2020,Taranaki,1,0,0,1,14,1,0,15
25/04/2020,Waikato,0,0,0,0,151,34,1,185
25/04/2020,Wairarapa,0,0,0,0,6,2,0,8
25/04/2020,Waitemata,0,3,0,3,155,69,2,224
25/04/2020,West Coast,0,0,0,0,4,1,1,5
25/04/2020,Whanganui,0,0,0,0,8,1,0,9
24/04/2020,Auckland,0,0,0,0,121,48,0,169
24/04/2020,Bay of Plenty,0,0,0,0,34,14,0,48
24/04/2020,Canterbury,1,1,1,2,97,65,10,162
24/04/2020,Capital and Coast,0,0,0,0,71,24,2,95
24/04/2020,Counties Manukau,0,1,0,1,107,23,0,130
24/04/2020,Hawke's Bay,0,0,0,0,36,6,0,42
24/04/2020,Hutt Valley,0,0,0,0,17,3,0,20
24/04/2020,Lakes,0,0,0,0,15,1,0,16
24/04/2020,Midcentral,0,0,0,0,26,5,0,31
24/04/2020,Nelson Marlborough,0,0,0,0,36,12,0,48
24/04/2020,Northland,0,0,0,0,26,2,0,28
24/04/2020,South Canterbury,0,0,0,0,15,1,0,16
24/04/2020,Southern,0,0,0,0,186,30,2,216
24/04/2020,Tairawhiti,0,0,0,0,3,1,0,4
24/04/2020,Taranaki,0,0,0,0,13,1,0,14
24/04/2020,Waikato,0,0,0,0,151,34,1,185
24/04/2020,Wairarapa,0,0,0,0,6,2,0,8
24/04/2020,Waitemata,3,0,1,3,155,66,2,221
24/04/2020,West Coast,0,0,0,0,4,1,1,5
24/04/2020,Whanganui,0,0,0,0,8,1,0,9
23/04/2020,Auckland,0,0,0,0,121,48,0,169
23/04/2020,Bay of Plenty,0,0,0,0,34,14,0,48
23/04/2020,Canterbury,2,0,0,2,96,64,9,160
23/04/2020,Capital and Coast,0,0,0,0,71,24,2,95
23/04/2020,Counties Manukau,0,0,0,0,107,22,0,129
23/04/2020,Hawke's Bay,0,0,0,0,36,6,0,42
23/04/2020,Hutt Valley,0,0,0,0,17,3,0,20
23/04/2020,Lakes,0,0,0,0,15,1,0,16
23/04/2020,Midcentral,0,0,0,0,26,5,0,31
23/04/2020,Nelson Marlborough,0,0,0,0,36,12,0,48
23/04/2020,Northland,0,0,0,0,26,2,0,28
23/04/2020,South Canterbury,0,0,0,0,15,1,0,16
23/04/2020,Southern,0,0,0,0,186,30,2,216
23/04/2020,Tairawhiti,0,0,0,0,3,1,0,4
23/04/2020,Taranaki,0,0,0,0,13,1,0,14
23/04/2020,Waikato,0,1,0,1,151,34,1,185
23/04/2020,Wairarapa,0,0,0,0,6,2,0,8
23/04/2020,Waitemata,1,1,0,2,152,66,1,218
23/04/2020,West Coast,0,0,0,0,4,1,1,5
23/04/2020,Whanganui,0,0,0,0,8,1,0,9
22/04/2020,Auckland,0,0,0,0,121,48,0,169
22/04/2020,Bay of Plenty,0,0,0,0,34,14,0,48
22/04/2020,Canterbury,0,2,1,2,94,64,9,158
22/04/2020,Capital and Coast,0,0,0,0,71,24,2,95
22/04/2020,Counties Manukau,1,0,0,1,107,22,0,129
22/04/2020,Hawke's Bay,1,0,0,1,36,6,0,42
22/04/2020,Hutt Valley,0,0,0,0,17,3,0,20
22/04/2020,Lakes,0,0,0,0,15,1,0,16
22/04/2020,Midcentral,0,0,0,0,26,5,0,31
22/04/2020,Nelson Marlborough,0,0,0,0,36,12,0,48
22/04/2020,Northland,0,0,0,0,26,2,0,28
22/04/2020,South Canterbury,0,0,0,0,15,1,0,16
22/04/2020,Southern,0,0,1,0,186,30,2,216
22/04/2020,Tairawhiti,0,0,0,0,3,1,0,4
22/04/2020,Taranaki,0,0,0,0,13,1,0,14
22/04/2020,Waikato,0,1,0,1,151,33,1,184
22/04/2020,Wairarapa,0,0,0,0,6,2,0,8
22/04/2020,Waitemata,0,0,0,0,151,65,1,216
22/04/2020,West Coast,0,0,0,0,4,1,1,5
22/04/2020,Whanganui,0,0,0,0,8,1,0,9
21/04/2020,Auckland,0,1,0,1,121,48,0,169
21/04/2020,Bay of Plenty,0,0,0,0,34,14,0,48
21/04/2020,Canterbury,0,2,1,2,94,62,8,156
21/04/2020,Capital and Coast,0,0,0,0,71,24,2,95
21/04/2020,Counties Manukau,0,2,0,2,106,22,0,128
21/04/2020,Hawke's Bay,0,0,0,0,35,6,0,41
21/04/2020,Hutt Valley,0,0,0,0,17,3,0,20
21/04/2020,Lakes,0,0,0,0,15,1,0,16
21/04/2020,Midcentral,0,0,0,0,26,5,0,31
21/04/2020,Nelson Marlborough,0,0,0,0,36,12,0,48
21/04/2020,Northland,0,0,0,0,26,2,0,28
21/04/2020,South Canterbury,0,0,0,0,15,1,0,16
21/04/2020,Southern,0,0,0,0,186,30,1,216
21/04/2020,Tairawhiti,0,0,0,0,3,1,0,4
21/04/2020,Taranaki,0,0,0,0,13,1,0,14
21/04/2020,Waikato,1,0,0,1,151,32,1,183
21/04/2020,Wairarapa,0,0,0,0,6,2,0,8
21/04/2020,Waitemata,0,0,0,0,151,65,1,216
21/04/2020,West Coast,0,0,0,0,4,1,1,5
21/04/2020,Whanganui,0,0,0,0,8,1,0,9
20/04/2020,Auckland,0,0,0,0,121,47,0,168
20/04/2020,Bay of Plenty,0,0,0,0,34,14,0,48
20/04/2020,Canterbury,0,1,0,1,94,60,7,154
20/04/2020,Capital and Coast,0,2,0,2,71,24,2,95
20/04/2020,Counties Manukau,0,0,0,0,106,20,0,126
20/04/2020,Hawke's Bay,0,0,0,0,35,6,0,41
20/04/2020,Hutt Valley,0,0,0,0,17,3,0,20
20/04/2020,Lakes,0,0,0,0,15,1,0,16
20/04/2020,Midcentral,0,0,0,0,26,5,0,31
20/04/2020,Nelson Marlborough,0,0,0,0,36,12,0,48
20/04/2020,Northland,0,0,0,0,26,2,0,28
20/04/2020,South Canterbury,0,0,0,0,15,1,0,16
20/04/2020,Southern,0,0,0,0,186,30,1,216
20/04/2020,Tairawhiti,0,0,0,0,3,1,0,4
20/04/2020,Taranaki,0,0,0,0,13,1,0,14
20/04/2020,Waikato,0,0,0,0,150,32,1,182
20/04/2020,Wairarapa,0,0,0,0,6,2,0,8
20/04/2020,Waitemata,0,0,1,0,151,65,1,216
20/04/2020,West Coast,0,0,0,0,4,1,1,5
20/04/2020,Whanganui,0,0,0,0,8,1,0,9
19/04/2020,Auckland,0,0,0,0,121,47,0,168
19/04/2020,Bay of Plenty,2,0,0,2,34,14,0,48
19/04/2020,Canterbury,3,0,0,3,94,59,7,153
19/04/2020,Capital and Coast,0,0,0,0,71,22,2,93
19/04/2020,Counties Manukau,1,0,0,1,106,20,0,126
19/04/2020,Hawke's Bay,0,0,0,0,35,6,0,41
19/04/2020,Hutt Valley,0,0,0,0,17,3,0,20
19/04/2020,Lakes,0,0,0,0,15,1,0,16
19/04/2020,Midcentral,0,0,0,0,26,5,0,31
19/04/2020,Nelson Marlborough,0,0,0,0,36,12,0,48
19/04/2020,Northland,0,0,0,0,26,2,0,28
19/04/2020,South Canterbury,1,0,0,1,15,1,0,16
19/04/2020,Southern,0,0,0,0,186,30,1,216
19/04/2020,Tairawhiti,0,0,0,0,3,1,0,4
19/04/2020,Taranaki,0,0,0,0,13,1,0,14
19/04/2020,Waikato,0,1,0,1,150,32,1,182
19/04/2020,Wairarapa,0,0,0,0,6,2,0,8
19/04/2020,Waitemata,0,1,0,1,151,65,0,216
19/04/2020,West Coast,0,0,0,0,4,1,1,5
19/04/2020,Whanganui,0,1,0,1,8,1,0,9
18/04/2020,Auckland,0,1,0,1,121,47,0,168
18/04/2020,Bay of Plenty,0,0,0,0,32,14,0,46
18/04/2020,Canterbury,2,0,0,2,91,59,7,150
18/04/2020,Capital and Coast,0,0,0,0,71,22,2,93
18/04/2020,Counties Manukau,2,0,0,2,105,20,0,125
18/04/2020,Hawke's Bay,0,0,0,0,35,6,0,41
18/04/2020,Hutt Valley,0,0,0,0,17,3,0,20
18/04/2020,Lakes,0,0,0,0,15,1,0,16
18/04/2020,Midcentral,0,0,0,0,26,5,0,31
18/04/2020,Nelson Marlborough,0,0,0,0,36,12,0,48
18/04/2020,Northland,0,0,0,0,26,2,0,28
18/04/2020,South Canterbury,0,0,0,0,14,1,0,15
18/04/2020,Southern,0,0,0,0,186,30,1,216
18/04/2020,Tairawhiti,0,0,0,0,3,1,0,4
18/04/2020,Taranaki,0,0,0,0,13,1,0,14
18/04/2020,Waikato,0,1,0,1,150,31,1,181
18/04/2020,Wairarapa,0,0,0,0,6,2,0,8
18/04/2020,Waitemata,1,3,0,4,151,64,0,215
18/04/2020,West Coast,0,0,0,0,4,1,1,5
18/04/2020,Whanganui,0,0,0,0,8,0,0,8
17/04/2020,Auckland,0,1,0,1,121,46,0,167
17/04/2020,Bay of Plenty,1,0,0,1,32,14,0,46
17/04/2020,Canterbury,0,0,0,0,89,59,7,148
17/04/2020,Capital and Coast,0,1,0,1,71,22,2,93
17/04/2020,Counties Manukau,0,1,0,1,103,20,0,123
17/04/2020,Hawke's Bay,0,0,0,0,35,6,0,41
17/04/2020,Hutt Valley,0,0,0,0,17,3,0,20
17/04/2020,Lakes,1,0,0,1,15,1,0,16
17/04/2020,Midcentral,2,0,0,2,26,5,0,31
17/04/2020,Nelson Marlborough,0,0,0,0,36,12,0,48
17/04/2020,Northland,0,0,0,0,26,2,0,28
17/04/2020,South Canterbury,1,0,0,1,14,1,0,15
17/04/2020,Southern,0,2,0,2,186,30,1,216
17/04/2020,Tairawhiti,0,0,0,0,3,1,0,4
17/04/2020,Taranaki,0,0,0,0,13,1,0,14
17/04/2020,Waikato,0,0,0,0,150,30,1,180
17/04/2020,Wairarapa,0,0,0,0,6,2,0,8
17/04/2020,Waitemata,0,1,0,1,150,61,0,211
17/04/2020,West Coast,0,0,0,0,4,1,1,5
17/04/2020,Whanganui,1,0,0,1,8,0,0,8
16/04/2020,Auckland,1,1,0,2,121,45,0,166
16/04/2020,Bay of Plenty,0,0,0,0,31,14,0,45
16/04/2020,Canterbury,3,0,1,3,89,59,7,148
16/04/2020,Capital and Coast,1,0,0,1,71,21,2,92
16/04/2020,Counties Manukau,3,0,0,3,103,19,0,122
16/04/2020,Hawke's Bay,0,0,0,0,35,6,0,41
16/04/2020,Hutt Valley,0,0,0,0,17,3,0,20
16/04/2020,Lakes,0,0,0,0,14,1,0,15
16/04/2020,Midcentral,0,0,0,0,24,5,0,29
16/04/2020,Nelson Marlborough,0,0,0,0,36,12,0,48
16/04/2020,Northland,1,0,0,1,26,2,0,28
16/04/2020,South Canterbury,0,0,0,0,13,1,0,14
16/04/2020,Southern,0,1,0,1,186,28,1,214
16/04/2020,Tairawhiti,0,0,0,0,3,1,0,4
16/04/2020,Taranaki,0,0,0,0,13,1,0,14
16/04/2020,Waikato,0,1,1,1,150,30,1,180
16/04/2020,Wairarapa,0,0,0,0,6,2,0,8
16/04/2020,Waitemata,4,1,0,5,150,60,0,210
16/04/2020,West Coast,0,0,0,0,4,1,1,5
16/04/2020,Whanganui,0,0,0,0,7,0,0,7
15/04/2020,Auckland,0,0,0,0,120,44,0,164
15/04/2020,Bay of Plenty,0,0,0,0,31,14,0,45
15/04/2020,Canterbury,1,1,0,2,86,59,6,145
15/04/2020,Capital and Coast,0,3,0,3,70,21,2,91
15/04/2020,Counties Manukau,0,0,0,0,100,19,0,119
15/04/2020,Hawke's Bay,0,0,0,0,35,6,0,41
15/04/2020,Hutt Valley,0,0,0,0,17,3,0,20
15/04/2020,Lakes,0,0,0,0,14,1,0,15
15/04/2020,Midcentral,0,1,0,1,24,5,0,29
15/04/2020,Nelson Marlborough,0,0,0,0,36,12,0,48
15/04/2020,Northland,0,0,0,0,25,2,0,27
15/04/2020,South Canterbury,1,0,0,1,13,1,0,14
15/04/2020,Southern,1,0,0,1,186,27,1,213
15/04/2020,Tairawhiti,0,0,0,0,3,1,0,4
15/04/2020,Taranaki,0,0,0,0,13,1,0,14
15/04/2020,Waikato,0,2,0,2,150,29,0,179
15/04/2020,Wairarapa,0,0,0,0,6,2,0,8
15/04/2020,Waitemata,1,0,0,1,146,59,0,205
15/04/2020,West Coast,0,0,0,0,4,1,1,5
15/04/2020,Whanganui,0,0,0,0,7,0,0,7
14/04/2020,Auckland,0,1,0,1,120,44,0,164
14/04/2020,Bay of Plenty,0,3,0,3,31,14,0,45
14/04/2020,Canterbury,1,0,0,1,85,58,6,143
14/04/2020,Capital and Coast,0,0,0,0,70,18,2,88
14/04/2020,Counties Manukau,4,1,0,5,100,19,0,119
14/04/2020,Hawke's Bay,0,0,0,0,35,6,0,41
14/04/2020,Hutt Valley,0,0,0,0,17,3,0,20
14/04/2020,Lakes,0,0,0,0,14,1,0,15
14/04/2020,Midcentral,0,0,0,0,24,4,0,28
14/04/2020,Nelson Marlborough,0,0,0,0,36,12,0,48
14/04/2020,Northland,0,0,0,0,25,2,0,27
14/04/2020,South Canterbury,1,0,0,1,12,1,0,13
14/04/2020,Southern,0,2,1,2,185,27,1,212
14/04/2020,Tairawhiti,2,0,0,2,3,1,0,4
14/04/2020,Taranaki,0,0,0,0,13,1,0,14
14/04/2020,Waikato,0,1,0,1,150,27,0,177
14/04/2020,Wairarapa,0,0,0,0,6,2,0,8
14/04/2020,Waitemata,0,0,0,0,145,59,0,204
14/04/2020,West Coast,0,0,0,0,4,1,1,5
14/04/2020,Whanganui,0,0,0,0,7,0,0,7
13/04/2020,Auckland,0,1,0,1,120,43,0,163
13/04/2020,Bay of Plenty,0,0,0,0,31,11,0,42
13/04/2020,Canterbury,1,0,3,1,84,58,6,142
13/04/2020,Capital and Coast,0,0,1,0,70,18,2,88
13/04/2020,Counties Manukau,0,1,0,1,96,18,0,114
13/04/2020,Hawke's Bay,0,0,0,0,35,6,0,41
13/04/2020,Hutt Valley,0,0,0,0,17,3,0,20
13/04/2020,Lakes,0,0,0,0,14,1,0,15
13/04/2020,Midcentral,0,0,0,0,24,4,0,28
13/04/2020,Nelson Marlborough,0,0,0,0,36,12,0,48
13/04/2020,Northland,1,0,0,1,25,2,0,27
13/04/2020,South Canterbury,0,0,0,0,11,1,0,12
13/04/2020,Southern,0,1,0,1,185,25,0,210
13/04/2020,Tairawhiti,0,0,0,0,1,1,0,2
13/04/2020,Taranaki,0,0,0,0,13,1,0,14
13/04/2020,Waikato,0,0,0,0,150,26,0,176
13/04/2020,Wairarapa,0,0,0,0,6,2,0,8
13/04/2020,Waitemata,1,5,0,6,145,59,0,204
13/04/2020,West Coast,0,0,0,0,4,1,1,5
13/04/2020,Whanganui,0,0,0,0,7,0,0,7
12/04/2020,Auckland,0,3,0,3,120,42,0,162
12/04/2020,Bay of Plenty,0,0,0,0,31,11,0,42
12/04/2020,Canterbury,2,1,1,3,83,58,3,141
12/04/2020,Capital and Coast,1,1,0,2,70,18,1,88
12/04/2020,Counties Manukau,0,0,0,0,96,17,0,113
12/04/2020,Hawke's Bay,2,0,0,2,35,6,0,41
12/04/2020,Hutt Valley,0,0,0,0,17,3,0,20
12/04/2020,Lakes,2,0,0,2,14,1,0,15
12/04/2020,Midcentral,0,0,0,0,24,4,0,28
12/04/2020,Nelson Marlborough,0,0,0,0,36,12,0,48
12/04/2020,Northland,0,0,0,0,24,2,0,26
12/04/2020,South Canterbury,0,0,0,0,11,1,0,12
12/04/2020,Southern,0,4,0,4,185,24,0,209
12/04/2020,Tairawhiti,0,0,0,0,1,1,0,2
12/04/2020,Taranaki,0,0,0,0,13,1,0,14
12/04/2020,Waikato,0,0,0,0,150,26,0,176
12/04/2020,Wairarapa,0,0,0,0,6,2,0,8
12/04/2020,Waitemata,4,0,0,4,144,54,0,198
12/04/2020,West Coast,0,0,0,0,4,1,1,5
12/04/2020,Whanganui,0,0,0,0,7,0,0,7
11/04/2020,Auckland,1,2,0,3,120,39,0,159
11/04/2020,Bay of Plenty,0,0,0,0,31,11,0,42
11/04/2020,Canterbury,0,1,0,1,81,57,2,138
11/04/2020,Capital and Coast,0,0,0,0,69,17,1,86
11/04/2020,Counties Manukau,1,0,0,1,96,17,0,113
11/04/2020,Hawke's Bay,0,0,0,0,33,6,0,39
11/04/2020,Hutt Valley,0,0,0,0,17,3,0,20
11/04/2020,Lakes,0,0,0,0,12,1,0,13
11/04/2020,Midcentral,0,0,0,0,24,4,0,28
11/04/2020,Nelson Marlborough,0,0,0,0,36,12,0,48
11/04/2020,Northland,1,0,0,1,24,2,0,26
11/04/2020,South Canterbury,1,0,0,1,11,1,0,12
11/04/2020,Southern,0,0,0,0,185,20,0,205
11/04/2020,Tairawhiti,0,1,0,1,1,1,0,2
11/04/2020,Taranaki,0,0,0,0,13,1,0,14
11/04/2020,Waikato,4,5,0,9,150,26,0,176
11/04/2020,Wairarapa,0,0,0,0,6,2,0,8
11/04/2020,Waitemata,5,3,0,8,140,54,0,194
11/04/2020,West Coast,0,0,0,0,4,1,1,5
11/04/2020,Whanganui,0,0,0,0,7,0,0,7
10/04/2020,Auckland,0,4,0,4,119,37,0,156
10/04/2020,Bay of Plenty,1,1,0,2,31,11,0,42
10/04/2020,Canterbury,0,2,1,2,81,56,2,137
10/04/2020,Capital and Coast,0,0,1,0,69,17,1,86
10/04/2020,Counties Manukau,1,0,0,1,95,17,0,112
10/04/2020,Hawke's Bay,0,1,0,1,33,6,0,39
10/04/2020,Hutt Valley,0,0,0,0,17,3,0,20
10/04/2020,Lakes,0,1,0,1,12,1,0,13
10/04/2020,Midcentral,0,0,0,0,24,4,0,28
10/04/2020,Nelson Marlborough,0,0,0,0,36,12,0,48
10/04/2020,Northland,2,0,0,2,23,2,0,25
10/04/2020,South Canterbury,0,0,0,0,10,1,0,11
10/04/2020,Southern,0,5,0,5,185,20,0,205
10/04/2020,Tairawhiti,0,0,0,0,1,0,0,1
10/04/2020,Taranaki,0,0,0,0,13,1,0,14
10/04/2020,Waikato,0,2,0,2,146,21,0,167
10/04/2020,Wairarapa,0,0,0,0,6,2,0,8
10/04/2020,Waitemata,4,3,0,7,135,51,0,186
10/04/2020,West Coast,0,0,0,0,4,1,1,5
10/04/2020,Whanganui,0,0,0,0,7,0,0,7
09/04/2020,Auckland,8,3,0,11,119,33,0,152
09/04/2020,Bay of Plenty,0,2,0,2,30,10,0,40
09/04/2020,Canterbury,5,5,1,10,81,54,1,135
09/04/2020,Capital and Coast,2,0,0,2,69,17,0,86
09/04/2020,Counties Manukau,5,0,0,5,94,17,0,111
09/04/2020,Hawke's Bay,1,1,0,2,33,5,0,38
09/04/2020,Hutt Valley,0,0,0,0,17,3,0,20
09/04/2020,Lakes,0,0,0,0,12,0,0,12
09/04/2020,Midcentral,0,0,0,0,24,4,0,28
09/04/2020,Nelson Marlborough,0,0,0,0,36,12,0,48
09/04/2020,Northland,0,1,0,1,21,2,0,23
09/04/2020,South Canterbury,0,0,0,0,10,1,0,11
09/04/2020,Southern,2,2,0,4,185,15,0,200
09/04/2020,Tairawhiti,0,0,0,0,1,0,0,1
09/04/2020,Taranaki,0,0,0,0,13,1,0,14
09/04/2020,Waikato,3,0,0,3,146,19,0,165
09/04/2020,Wairarapa,0,0,0,0,6,2,0,8
09/04/2020,Waitemata,4,0,0,4,131,48,0,179
09/04/2020,West Coast,0,0,0,0,4,1,1,5
09/04/2020,Whanganui,0,0,0,0,7,0,0,7
08/04/2020,Auckland,3,1,0,4,111,30,0,141
08/04/2020,Bay of Plenty,0,0,0,0,30,8,0,38
08/04/2020,Canterbury,1,5,0,6,76,49,0,125
08/04/2020,Capital and Coast,3,0,0,3,67,17,0,84
08/04/2020,Counties Manukau,2,0,0,2,89,17,0,106
08/04/2020,Hawke's Bay,1,0,0,1,32,4,0,36
08/04/2020,Hutt Valley,0,0,0,0,17,3,0,20
08/04/2020,Lakes,0,0,0,0,12,0,0,12
08/04/2020,Midcentral,0,0,0,0,24,4,0,28
08/04/2020,Nelson Marlborough,0,0,0,0,36,12,0,48
08/04/2020,Northland,0,0,0,0,21,1,0,22
08/04/2020,South Canterbury,1,0,0,1,10,1,0,11
08/04/2020,Southern,2,1,0,3,183,13,0,196
08/04/2020,Tairawhiti,0,0,0,0,1,0,0,1
08/04/2020,Taranaki,0,0,0,0,13,1,0,14
08/04/2020,Waikato,0,3,0,3,143,19,0,162
08/04/2020,Wairarapa,0,0,0,0,6,2,0,8
08/04/2020,Waitemata,4,1,0,5,127,48,0,175
08/04/2020,West Coast,0,0,0,0,4,1,1,5
08/04/2020,Whanganui,0,0,0,0,7,0,0,7
07/04/2020,Auckland,1,1,0,2,108,29,0,137
07/04/2020,Bay of Plenty,1,0,0,1,30,8,0,38
07/04/2020,Canterbury,1,3,0,4,75,44,0,119
07/04/2020,Capital and Coast,0,0,0,0,64,17,0,81
07/04/2020,Counties Manukau,1,1,0,2,87,17,0,104
07/04/2020,Hawke's Bay,1,0,0,1,31,4,0,35
07/04/2020,Hutt Valley,0,0,0,0,17,3,0,20
07/04/2020,Lakes,0,0,0,0,12,0,0,12
07/04/2020,Midcentral,0,0,0,0,24,4,0,28
07/04/2020,Nelson Marlborough,0,2,0,2,36,12,0,48
07/04/2020,Northland,2,0,0,2,21,1,0,22
07/04/2020,South Canterbury,0,0,0,0,9,1,0,10
07/04/2020,Southern,7,2,0,9,181,12,0,193
07/04/2020,Tairawhiti,0,0,0,0,1,0,0,1
07/04/2020,Taranaki,0,0,0,0,13,1,0,14
07/04/2020,Waikato,3,2,0,5,143,16,0,159
07/04/2020,Wairarapa,0,0,0,0,6,2,0,8
07/04/2020,Waitemata,7,2,0,9,123,47,0,170
07/04/2020,West Coast,0,0,0,0,4,1,1,5
07/04/2020,Whanganui,0,0,0,0,7,0,0,7
06/04/2020,Auckland,3,3,0,6,107,28,0,135
06/04/2020,Bay of Plenty,2,2,0,4,29,8,0,37
06/04/2020,Canterbury,6,5,0,11,74,41,0,115
06/04/2020,Capital and Coast,1,1,0,2,64,17,0,81
06/04/2020,Counties Manukau,4,3,0,7,86,16,0,102
06/04/2020,Hawke's Bay,1,0,0,1,30,4,0,34
06/04/2020,Hutt Valley,0,0,0,0,17,3,0,20
06/04/2020,Lakes,0,0,0,0,12,0,0,12
06/04/2020,Midcentral,2,0,0,2,24,4,0,28
06/04/2020,Nelson Marlborough,1,1,0,2,36,10,0,46
06/04/2020,Northland,1,0,0,1,19,1,0,20
06/04/2020,South Canterbury,0,0,0,0,9,1,0,10
06/04/2020,Southern,8,0,0,8,174,10,0,184
06/04/2020,Tairawhiti,0,0,0,0,1,0,0,1
06/04/2020,Taranaki,0,0,0,0,13,1,0,14
06/04/2020,Waikato,2,5,0,7,140,14,0,154
06/04/2020,Wairarapa,0,0,0,0,6,2,0,8
06/04/2020,Waitemata,0,2,0,2,116,45,0,161
06/04/2020,West Coast,0,0,0,0,4,1,1,5
06/04/2020,Whanganui,0,0,0,0,7,0,0,7
05/04/2020,Auckland,4,5,0,9,104,25,0,129
05/04/2020,Bay of Plenty,1,0,0,1,27,6,0,33
05/04/2020,Canterbury,1,3,0,4,68,36,0,104
05/04/2020,Capital and Coast,0,0,0,0,63,16,0,79
05/04/2020,Counties Manukau,7,3,0,10,82,13,0,95
05/04/2020,Hawke's Bay,3,1,0,4,29,4,0,33
05/04/2020,Hutt Valley,0,1,0,1,17,3,0,20
05/04/2020,Lakes,0,0,0,0,12,0,0,12
05/04/2020,Midcentral,2,1,0,3,22,4,0,26
05/04/2020,Nelson Marlborough,2,3,0,5,35,9,0,44
05/04/2020,Northland,2,0,0,2,18,1,0,19
05/04/2020,South Canterbury,0,0,0,0,9,1,0,10
05/04/2020,Southern,14,3,0,17,166,10,0,176
05/04/2020,Tairawhiti,0,0,0,0,1,0,0,1
05/04/2020,Taranaki,0,0,0,0,13,1,0,14
05/04/2020,Waikato,3,1,0,4,138,9,0,147
05/04/2020,Wairarapa,0,0,0,0,6,2,0,8
05/04/2020,Waitemata,5,4,0,9,116,43,0,159
05/04/2020,West Coast,0,1,0,1,4,1,1,5
05/04/2020,Whanganui,0,0,0,0,7,0,0,7
04/04/2020,Auckland,5,4,0,9,100,20,0,120
04/04/2020,Bay of Plenty,0,0,0,0,26,6,0,32
04/04/2020,Canterbury,11,6,0,17,67,33,0,100
04/04/2020,Capital and Coast,3,3,0,6,63,16,0,79
04/04/2020,Counties Manukau,3,1,0,4,75,10,0,85
04/04/2020,Hawke's Bay,0,0,0,0,26,3,0,29
04/04/2020,Hutt Valley,0,0,0,0,17,2,0,19
04/04/2020,Lakes,1,0,0,1,12,0,0,12
04/04/2020,Midcentral,2,1,0,3,20,3,0,23
04/04/2020,Nelson Marlborough,3,2,0,5,33,6,0,39
04/04/2020,Northland,1,0,0,1,16,1,0,17
04/04/2020,South Canterbury,0,0,0,0,9,1,0,10
04/04/2020,Southern,9,1,0,10,152,7,0,159
04/04/2020,Tairawhiti,0,0,0,0,1,0,0,1
04/04/2020,Taranaki,0,0,0,0,13,1,0,14
04/04/2020,Waikato,4,2,0,6,135,8,0,143
04/04/2020,Wairarapa,0,0,0,0,6,2,0,8
04/04/2020,Waitemata,5,10,0,15,111,39,0,150
04/04/2020,West Coast,0,0,0,0,4,0,1,4
04/04/2020,Whanganui,0,0,0,0,7,0,0,7
03/04/2020,Auckland,1,2,0,3,95,16,0,111
03/04/2020,Bay of Plenty,0,1,0,1,26,6,0,32
03/04/2020,Canterbury,5,6,0,11,56,27,0,83
03/04/2020,Capital and Coast,3,3,0,6,60,13,0,73
03/04/2020,Counties Manukau,7,1,0,8,72,9,0,81
03/04/2020,Hawke's Bay,5,0,0,5,26,3,0,29
03/04/2020,Hutt Valley,0,1,0,1,17,2,0,19
03/04/2020,Lakes,0,0,0,0,11,0,0,11
03/04/2020,Midcentral,0,0,0,0,18,2,0,20
03/04/2020,Nelson Marlborough,1,1,0,2,30,4,0,34
03/04/2020,Northland,2,0,0,2,15,1,0,16
03/04/2020,South Canterbury,0,0,0,0,9,1,0,10
03/04/2020,Southern,14,1,0,15,143,6,0,149
03/04/2020,Tairawhiti,0,0,0,0,1,0,0,1
03/04/2020,Taranaki,0,0,0,0,13,1,0,14
03/04/2020,Waikato,11,2,0,13,131,6,0,137
03/04/2020,Wairarapa,0,0,0,0,6,2,0,8
03/04/2020,Waitemata,6,2,0,8,106,29,0,135
03/04/2020,West Coast,0,0,0,0,4,0,1,4
03/04/2020,Whanganui,0,0,0,0,7,0,0,7
02/04/2020,Auckland,3,0,0,3,94,14,0,108
02/04/2020,Bay of Plenty,3,1,0,4,26,5,0,31
02/04/2020,Canterbury,4,5,0,9,51,21,0,72
02/04/2020,Capital and Coast,2,2,0,4,57,10,0,67
02/04/2020,Counties Manukau,5,1,0,6,65,8,0,73
02/04/2020,Hawke's Bay,2,3,0,5,21,3,0,24
02/04/2020,Hutt Valley,4,0,0,4,17,1,0,18
02/04/2020,Lakes,0,0,0,0,11,0,0,11
02/04/2020,Midcentral,1,0,0,1,18,2,0,20
02/04/2020,Nelson Marlborough,3,0,0,3,29,3,0,32
02/04/2020,Northland,1,0,0,1,13,1,0,14
02/04/2020,South Canterbury,0,0,0,0,9,1,0,10
02/04/2020,Southern,17,1,0,18,129,5,0,134
02/04/2020,Tairawhiti,0,0,0,0,1,0,0,1
02/04/2020,Taranaki,0,0,0,0,13,1,0,14
02/04/2020,Waikato,7,1,0,8,120,4,0,124
02/04/2020,Wairarapa,0,2,0,2,6,2,0,8
02/04/2020,Waitemata,5,7,0,12,100,27,0,127
02/04/2020,West Coast,0,0,0,0,4,0,1,4
02/04/2020,Whanganui,2,0,0,2,7,0,0,7
01/04/2020,Auckland,3,1,0,4,91,14,0,105
01/04/2020,Bay of Plenty,6,0,0,6,23,4,0,27
01/04/2020,Canterbury,0,2,0,2,47,16,0,63
01/04/2020,Capital and Coast,1,2,0,3,55,8,0,63
01/04/2020,Counties Manukau,5,0,0,5,60,7,0,67
01/04/2020,Hawke's Bay,4,0,0,4,19,0,0,19
01/04/2020,Hutt Valley,0,0,0,0,13,1,0,14
01/04/2020,Lakes,0,0,0,0,11,0,0,11
01/04/2020,Midcentral,1,0,0,1,17,2,0,19
01/04/2020,Nelson Marlborough,3,1,0,4,26,3,0,29
01/04/2020,Northland,1,0,0,1,12,1,0,13
01/04/2020,South Canterbury,0,0,0,0,9,1,0,10
01/04/2020,Southern,15,1,0,16,112,4,0,116
01/04/2020,Tairawhiti,0,0,0,0,1,0,0,1
01/04/2020,Taranaki,1,0,0,1,13,1,0,14
01/04/2020,Waikato,8,1,0,9,113,3,0,116
01/04/2020,Wairarapa,0,0,0,0,6,0,0,6
01/04/2020,Waitemata,9,5,0,14,95,20,0,115
01/04/2020,West Coast,1,0,0,1,4,0,1,4
01/04/2020,Whanganui,2,0,0,2,5,0,0,5
31/03/2020,Auckland,4,4,0,8,88,13,0,101
31/03/2020,Bay of Plenty,2,1,0,3,17,4,0,21
31/03/2020,Canterbury,2,1,0,3,47,14,0,61
31/03/2020,Capital and Coast,2,0,0,2,54,6,0,60
31/03/2020,Counties Manukau,5,2,0,7,55,7,0,62
31/03/2020,Hawke's Bay,0,0,0,0,15,0,0,15
31/03/2020,Hutt Valley,1,0,0,1,13,1,0,14
31/03/2020,Lakes,0,0,0,0,11,0,0,11
31/03/2020,Midcentral,4,0,0,4,16,2,0,18
31/03/2020,Nelson Marlborough,2,0,0,2,23,2,0,25
31/03/2020,Northland,1,0,0,1,11,1,0,12
31/03/2020,South Canterbury,0,0,0,0,9,1,0,10
31/03/2020,Southern,7,2,0,9,97,3,0,100
31/03/2020,Tairawhiti,0,0,0,0,1,0,0,1
31/03/2020,Taranaki,0,0,0,0,12,1,0,13
31/03/2020,Waikato,24,0,0,24,105,2,0,107
31/03/2020,Wairarapa,1,0,0,1,6,0,0,6
31/03/2020,Waitemata,9,3,0,12,86,15,0,101
31/03/2020,West Coast,0,0,0,0,3,0,1,3
31/03/2020,Whanganui,0,0,0,0,3,0,0,3
30/03/2020,Auckland,2,1,0,3,84,9,0,93
30/03/2020,Bay of Plenty,4,0,0,4,15,3,0,18
30/03/2020,Canterbury,1,0,0,1,45,13,0,58
30/03/2020,Capital and Coast,0,1,0,1,52,6,0,58
30/03/2020,Counties Manukau,7,2,0,9,50,5,0,55
30/03/2020,Hawke's Bay,3,0,0,3,15,0,0,15
30/03/2020,Hutt Valley,0,0,0,0,12,1,0,13
30/03/2020,Lakes,2,0,0,2,11,0,0,11
30/03/2020,Midcentral,1,0,0,1,12,2,0,14
30/03/2020,Nelson Marlborough,1,1,0,2,21,2,0,23
30/03/2020,Northland,1,0,0,1,10,1,0,11
30/03/2020,South Canterbury,1,0,0,1,9,1,0,10
30/03/2020,Southern,9,0,0,9,90,1,0,91
30/03/2020,Tairawhiti,0,0,0,0,1,0,0,1
30/03/2020,Taranaki,1,0,0,1,12,1,0,13
30/03/2020,Waikato,5,0,0,5,81,2,0,83
30/03/2020,Wairarapa,0,0,0,0,5,0,0,5
30/03/2020,Waitemata,6,3,0,9,77,12,0,89
30/03/2020,West Coast,0,0,0,0,3,0,1,3
30/03/2020,Whanganui,0,0,0,0,3,0,0,3
29/03/2020,Auckland,8,1,0,9,82,8,0,90
29/03/2020,Bay of Plenty,0,0,0,0,11,3,0,14
29/03/2020,Canterbury,1,1,0,2,44,13,0,57
29/03/2020,Capital and Coast,7,1,0,8,52,5,0,57
29/03/2020,Counties Manukau,4,0,0,4,43,3,0,46
29/03/2020,Hawke's Bay,0,0,0,0,12,0,0,12
29/03/2020,Hutt Valley,0,0,0,0,12,1,0,13
29/03/2020,Lakes,0,0,0,0,9,0,0,9
29/03/2020,Midcentral,1,1,0,2,11,2,0,13
29/03/2020,Nelson Marlborough,1,0,0,1,20,1,0,21
29/03/2020,Northland,2,0,0,2,9,1,0,10
29/03/2020,South Canterbury,1,1,0,2,8,1,0,9
29/03/2020,Southern,12,0,0,12,81,1,0,82
29/03/2020,Tairawhiti,0,0,0,0,1,0,0,1
29/03/2020,Taranaki,0,0,0,0,11,1,0,12
29/03/2020,Waikato,16,0,0,16,76,2,0,78
29/03/2020,Wairarapa,0,0,0,0,5,0,0,5
29/03/2020,Waitemata,14,2,0,16,71,9,0,80
29/03/2020,West Coast,0,0,1,0,3,0,1,3
29/03/2020,Whanganui,0,0,0,0,3,0,0,3
28/03/2020,Auckland,13,2,0,15,74,7,0,81
28/03/2020,Bay of Plenty,2,0,0,2,11,3,0,14
28/03/2020,Canterbury,5,4,0,9,43,12,0,55
28/03/2020,Capital and Coast,5,0,0,5,45,4,0,49
28/03/2020,Counties Manukau,6,1,0,7,39,3,0,42
28/03/2020,Hawke's Bay,1,0,0,1,12,0,0,12
28/03/2020,Hutt Valley,0,0,0,0,12,1,0,13
28/03/2020,Lakes,1,0,0,1,9,0,0,9
28/03/2020,Midcentral,1,0,0,1,10,1,0,11
28/03/2020,Nelson Marlborough,1,0,0,1,19,1,0,20
28/03/2020,Northland,0,0,0,0,7,1,0,8
28/03/2020,South Canterbury,1,0,0,1,7,0,0,7
28/03/2020,Southern,13,0,0,13,69,1,0,70
28/03/2020,Tairawhiti,0,0,0,0,1,0,0,1
28/03/2020,Taranaki,0,0,0,0,11,1,0,12
28/03/2020,Waikato,3,0,0,3,60,2,0,62
28/03/2020,Wairarapa,0,0,0,0,5,0,0,5
28/03/2020,Waitemata,13,0,0,13,57,7,0,64
28/03/2020,West Coast,0,0,0,0,3,0,0,3
28/03/2020,Whanganui,0,0,0,0,3,0,0,3
27/03/2020,Auckland,6,1,0,7,61,5,0,66
27/03/2020,Bay of Plenty,3,0,0,3,9,3,0,12
27/03/2020,Canterbury,2,2,0,4,38,8,0,46
27/03/2020,Capital and Coast,3,0,0,3,40,4,0,44
27/03/2020,Counties Manukau,5,1,0,6,33,2,0,35
27/03/2020,Hawke's Bay,1,0,0,1,11,0,0,11
27/03/2020,Hutt Valley,3,0,0,3,12,1,0,13
27/03/2020,Lakes,0,0,0,0,8,0,0,8
27/03/2020,Midcentral,2,0,0,2,9,1,0,10
27/03/2020,Nelson Marlborough,0,0,0,0,18,1,0,19
27/03/2020,Northland,0,0,0,0,7,1,0,8
27/03/2020,South Canterbury,4,0,0,4,6,0,0,6
27/03/2020,Southern,19,0,0,19,56,1,0,57
27/03/2020,Tairawhiti,0,0,0,0,1,0,0,1
27/03/2020,Taranaki,5,0,0,5,11,1,0,12
27/03/2020,Waikato,11,0,0,11,57,2,0,59
27/03/2020,Wairarapa,0,0,0,0,5,0,0,5
27/03/2020,Waitemata,2,2,0,4,44,7,0,51
27/03/2020,West Coast,0,0,0,0,3,0,0,3
27/03/2020,Whanganui,3,0,0,3,3,0,0,3
26/03/2020,Auckland,11,1,0,12,55,4,0,59
26/03/2020,Bay of Plenty,2,1,0,3,6,3,0,9
26/03/2020,Canterbury,12,2,0,14,36,6,0,42
26/03/2020,Capital and Coast,2,1,0,3,37,4,0,41
26/03/2020,Counties Manukau,3,0,0,3,28,1,0,29
26/03/2020,Hawke's Bay,4,0,0,4,10,0,0,10
26/03/2020,Hutt Valley,4,0,0,4,9,1,0,10
26/03/2020,Lakes,1,0,0,1,8,0,0,8
26/03/2020,Midcentral,0,0,0,0,7,1,0,8
26/03/2020,Nelson Marlborough,0,0,0,0,18,1,0,19
26/03/2020,Northland,1,1,0,2,7,1,0,8
26/03/2020,South Canterbury,0,0,0,0,2,0,0,2
26/03/2020,Southern,7,0,0,7,37,1,0,38
26/03/2020,Tairawhiti,1,0,0,1,1,0,0,1
26/03/2020,Taranaki,1,1,0,2,6,1,0,7
26/03/2020,Waikato,10,0,0,10,46,2,0,48
26/03/2020,Wairarapa,0,0,0,0,5,0,0,5
26/03/2020,Waitemata,8,3,0,11,42,5,0,47
26/03/2020,West Coast,2,0,0,2,3,0,0,3
26/03/2020,Whanganui,0,0,0,0,0,0,0,0
25/03/2020,Auckland,11,0,0,11,44,3,0,47
25/03/2020,Bay of Plenty,2,0,0,2,4,2,0,6
25/03/2020,Canterbury,4,1,0,5,24,4,0,28
25/03/2020,Capital and Coast,4,0,0,4,35,3,0,38
25/03/2020,Counties Manukau,5,0,0,5,25,1,0,26
25/03/2020,Hawke's Bay,3,0,0,3,6,0,0,6
25/03/2020,Hutt Valley,1,0,0,1,5,1,0,6
25/03/2020,Lakes,3,0,0,3,7,0,0,7
25/03/2020,Midcentral,1,1,0,2,7,1,0,8
25/03/2020,Nelson Marlborough,4,0,0,4,18,1,0,19
25/03/2020,Northland,2,0,0,2,6,0,0,6
25/03/2020,South Canterbury,0,0,0,0,2,0,0,2
25/03/2020,Southern,9,0,0,9,30,1,0,31
25/03/2020,Tairawhiti,0,0,0,0,0,0,0,0
25/03/2020,Taranaki,1,0,0,1,5,0,0,5
25/03/2020,Waikato,20,1,0,21,36,2,0,38
25/03/2020,Wairarapa,0,0,0,0,5,0,0,5
25/03/2020,Waitemata,10,1,0,11,34,2,0,36
25/03/2020,West Coast,0,0,0,0,1,0,0,1
25/03/2020,Whanganui,0,0,0,0,0,0,0,0
24/03/2020,Auckland,7,0,0,7,33,3,0,36
24/03/2020,Bay of Plenty,1,2,0,3,2,2,0,4
24/03/2020,Canterbury,7,0,0,7,20,3,0,23
24/03/2020,Capital and Coast,10,0,0,10,31,3,0,34
24/03/2020,Counties Manukau,2,0,0,2,20,1,0,21
24/03/2020,Hawke's Bay,2,0,0,2,3,0,0,3
24/03/2020,Hutt Valley,0,0,0,0,4,1,0,5
24/03/2020,Lakes,1,0,0,1,4,0,0,4
24/03/2020,Midcentral,1,0,0,1,6,0,0,6
24/03/2020,Nelson Marlborough,3,1,0,4,14,1,0,15
24/03/2020,Northland,2,0,0,2,4,0,0,4
24/03/2020,South Canterbury,0,0,0,0,2,0,0,2
24/03/2020,Southern,7,0,0,7,21,1,0,22
24/03/2020,Tairawhiti,0,0,0,0,0,0,0,0
24/03/2020,Taranaki,0,0,0,0,4,0,0,4
24/03/2020,Waikato,2,0,0,2,16,1,0,17
24/03/2020,Wairarapa,2,0,0,2,5,0,0,5
24/03/2020,Waitemata,8,0,0,8,24,1,0,25
24/03/2020,West Coast,0,0,0,0,1,0,0,1
24/03/2020,Whanganui,0,0,0,0,0,0,0,0
23/03/2020,Auckland,7,0,0,7,26,3,0,29
23/03/2020,Bay of Plenty,0,0,0,0,1,0,0,1
23/03/2020,Canterbury,4,2,0,6,13,3,0,16
23/03/2020,Capital and Coast,8,1,0,9,21,3,0,24
23/03/2020,Counties Manukau,1,0,0,1,18,1,0,19
23/03/2020,Hawke's Bay,0,0,0,0,1,0,0,1
23/03/2020,Hutt Valley,1,1,0,2,4,1,0,5
23/03/2020,Lakes,1,0,0,1,3,0,0,3
23/03/2020,Midcentral,1,0,0,1,5,0,0,5
23/03/2020,Nelson Marlborough,2,0,0,2,11,0,0,11
23/03/2020,Northland,0,0,0,0,2,0,0,2
23/03/2020,South Canterbury,2,0,0,2,2,0,0,2
23/03/2020,Southern,4,0,0,4,14,1,0,15
23/03/2020,Tairawhiti,0,0,0,0,0,0,0,0
23/03/2020,Taranaki,0,0,0,0,4,0,0,4
23/03/2020,Waikato,4,0,0,4,14,1,0,15
23/03/2020,Wairarapa,0,0,0,0,3,0,0,3
23/03/2020,Waitemata,2,0,0,2,16,1,0,17
23/03/2020,West Coast,0,0,0,0,1,0,0,1
23/03/2020,Whanganui,0,0,0,0,0,0,0,0
22/03/2020,Auckland,7,1,0,8,19,3,0,22
22/03/2020,Bay of Plenty,0,0,0,0,1,0,0,1
22/03/2020,Canterbury,2,1,0,3,9,1,0,10
22/03/2020,Capital and Coast,5,2,0,7,13,2,0,15
22/03/2020,Counties Manukau,8,0,0,8,17,1,0,18
22/03/2020,Hawke's Bay,0,0,0,0,1,0,0,1
22/03/2020,Hutt Valley,1,0,0,1,3,0,0,3
22/03/2020,Lakes,0,0,0,0,2,0,0,2
22/03/2020,Midcentral,0,0,0,0,4,0,0,4
22/03/2020,Nelson Marlborough,5,0,0,5,9,0,0,9
22/03/2020,Northland,1,0,0,1,2,0,0,2
22/03/2020,South Canterbury,0,0,0,0,0,0,0,0
22/03/2020,Southern,2,0,0,2,10,1,0,11
22/03/2020,Tairawhiti,0,0,0,0,0,0,0,0
22/03/2020,Taranaki,0,0,0,0,4,0,0,4
22/03/2020,Waikato,2,1,0,3,10,1,0,11
22/03/2020,Wairarapa,0,0,0,0,3,0,0,3
22/03/2020,Waitemata,5,0,0,5,14,1,0,15
22/03/2020,West Coast,1,0,0,1,1,0,0,1
22/03/2020,Whanganui,0,0,0,0,0,0,0,0
21/03/2020,Auckland,4,0,0,4,12,2,0,14
21/03/2020,Bay of Plenty,1,0,0,1,1,0,0,1
21/03/2020,Canterbury,3,0,0,3,7,0,0,7
21/03/2020,Capital and Coast,1,0,0,1,8,0,0,8
21/03/2020,Counties Manukau,4,0,0,4,9,1,0,10
21/03/2020,Hawke's Bay,0,0,0,0,1,0,0,1
21/03/2020,Hutt Valley,0,0,0,0,2,0,0,2
21/03/2020,Lakes,0,0,0,0,2,0,0,2
21/03/2020,Midcentral,1,0,0,1,4,0,0,4
21/03/2020,Nelson Marlborough,2,0,0,2,4,0,0,4
21/03/2020,Northland,0,0,0,0,1,0,0,1
21/03/2020,South Canterbury,0,0,0,0,0,0,0,0
21/03/2020,Southern,0,0,0,0,8,1,0,9
21/03/2020,Tairawhiti,0,0,0,0,0,0,0,0
21/03/2020,Taranaki,2,0,0,2,4,0,0,4
21/03/2020,Waikato,3,0,0,3,8,0,0,8
21/03/2020,Wairarapa,2,0,0,2,3,0,0,3
21/03/2020,Waitemata,1,0,0,1,9,1,0,10
21/03/2020,West Coast,0,0,0,0,0,0,0,0
21/03/2020,Whanganui,0,0,0,0,0,0,0,0
20/03/2020,Auckland,1,0,0,1,8,2,0,10
20/03/2020,Bay of Plenty,0,0,0,0,0,0,0,0
20/03/2020,Canterbury,2,0,0,2,4,0,0,4
20/03/2020,Capital and Coast,0,0,0,0,7,0,0,7
20/03/2020,Counties Manukau,0,0,0,0,5,1,0,6
20/03/2020,Hawke's Bay,0,0,0,0,1,0,0,1
20/03/2020,Hutt Valley,0,0,0,0,2,0,0,2
20/03/2020,Lakes,1,0,0,1,2,0,0,2
20/03/2020,Midcentral,0,0,0,0,3,0,0,3
20/03/2020,Nelson Marlborough,2,0,0,2,2,0,0,2
20/03/2020,Northland,0,0,0,0,1,0,0,1
20/03/2020,South Canterbury,0,0,0,0,0,0,0,0
20/03/2020,Southern,2,0,0,2,8,1,0,9
20/03/2020,Tairawhiti,0,0,0,0,0,0,0,0
20/03/2020,Taranaki,0,0,0,0,2,0,0,2
20/03/2020,Waikato,1,0,0,1,5,0,0,5
20/03/2020,Wairarapa,0,0,0,0,1,0,0,1
20/03/2020,Waitemata,2,0,0,2,8,1,0,9
20/03/2020,West Coast,0,0,0,0,0,0,0,0
20/03/2020,Whanganui,0,0,0,0,0,0,0,0
19/03/2020,Auckland,2,2,0,4,7,2,0,9
19/03/2020,Bay of Plenty,0,0,0,0,0,0,0,0
19/03/2020,Canterbury,0,0,0,0,2,0,0,2
19/03/2020,Capital and Coast,2,0,0,2,7,0,0,7
19/03/2020,Counties Manukau,1,0,0,1,5,1,0,6
19/03/2020,Hawke's Bay,1,0,0,1,1,0,0,1
19/03/2020,Hutt Valley,2,0,0,2,2,0,0,2
19/03/2020,Lakes,0,0,0,0,1,0,0,1
19/03/2020,Midcentral,3,0,0,3,3,0,0,3
19/03/2020,Nelson Marlborough,0,0,0,0,0,0,0,0
19/03/2020,Northland,0,0,0,0,1,0,0,1
19/03/2020,South Canterbury,0,0,0,0,0,0,0,0
19/03/2020,Southern,1,0,0,1,6,1,0,7
19/03/2020,Tairawhiti,0,0,0,0,0,0,0,0
19/03/2020,Taranaki,0,0,0,0,2,0,0,2
19/03/2020,Waikato,2,0,0,2,4,0,0,4
19/03/2020,Wairarapa,1,0,0,1,1,0,0,1
19/03/2020,Waitemata,1,0,0,1,6,1,0,7
19/03/2020,West Coast,0,0,0,0,0,0,0,0
19/03/2020,Whanganui,0,0,0,0,0,0,0,0
18/03/2020,Auckland,1,0,0,1,5,0,0,5
18/03/2020,Bay of Plenty,0,0,0,0,0,0,0,0
18/03/2020,Canterbury,1,0,0,1,2,0,0,2
18/03/2020,Capital and Coast,1,0,0,1,5,0,0,5
18/03/2020,Counties Manukau,0,0,0,0,4,1,0,5
18/03/2020,Hawke's Bay,0,0,0,0,0,0,0,0
18/03/2020,Hutt Valley,0,0,0,0,0,0,0,0
18/03/2020,Lakes,0,0,0,0,1,0,0,1
18/03/2020,Midcentral,0,0,0,0,0,0,0,0
18/03/2020,Nelson Marlborough,0,0,0,0,0,0,0,0
18/03/2020,Northland,0,0,0,0,1,0,0,1
18/03/2020,South Canterbury,0,0,0,0,0,0,0,0
18/03/2020,Southern,2,0,0,2,5,1,0,6
18/03/2020,Tairawhiti,0,0,0,0,0,0,0,0
18/03/2020,Taranaki,0,0,0,0,2,0,0,2
18/03/2020,Waikato,0,0,0,0,2,0,0,2
18/03/2020,Wairarapa,0,0,0,0,0,0,0,0
18/03/2020,Waitemata,0,0,0,0,5,1,0,6
18/03/2020,West Coast,0,0,0,0,0,0,0,0
18/03/2020,Whanganui,0,0,0,0,0,0,0,0
17/03/2020,Auckland,2,0,0,2,4,0,0,4
17/03/2020,Bay of Plenty,0,0,0,0,0,0,0,0
17/03/2020,Canterbury,1,0,0,1,1,0,0,1
17/03/2020,Capital and Coast,1,0,0,1,4,0,0,4
17/03/2020,Counties Manukau,1,0,0,1,4,1,0,5
17/03/2020,Hawke's Bay,0,0,0,0,0,0,0,0
17/03/2020,Hutt Valley,0,0,0,0,0,0,0,0
17/03/2020,Lakes,1,0,0,1,1,0,0,1
17/03/2020,Midcentral,0,0,0,0,0,0,0,0
17/03/2020,Nelson Marlborough,0,0,0,0,0,0,0,0
17/03/2020,Northland,1,0,0,1,1,0,0,1
17/03/2020,South Canterbury,0,0,0,0,0,0,0,0
17/03/2020,Southern,2,1,0,3,3,1,0,4
17/03/2020,Tairawhiti,0,0,0,0,0,0,0,0
17/03/2020,Taranaki,0,0,0,0,2,0,0,2
17/03/2020,Waikato,0,0,0,0,2,0,0,2
17/03/2020,Wairarapa,0,0,0,0,0,0,0,0
17/03/2020,Waitemata,2,0,0,2,5,1,0,6
17/03/2020,West Coast,0,0,0,0,0,0,0,0
17/03/2020,Whanganui,0,0,0,0,0,0,0,0
16/03/2020,Auckland,1,0,0,1,2,0,0,2
16/03/2020,Bay of Plenty,0,0,0,0,0,0,0,0
16/03/2020,Canterbury,0,0,0,0,0,0,0,0
16/03/2020,Capital and Coast,2,0,0,2,3,0,0,3
16/03/2020,Counties Manukau,0,0,0,0,3,1,0,4
16/03/2020,Hawke's Bay,0,0,0,0,0,0,0,0
16/03/2020,Hutt Valley,0,0,0,0,0,0,0,0
16/03/2020,Lakes,0,0,0,0,0,0,0,0
16/03/2020,Midcentral,0,0,0,0,0,0,0,0
16/03/2020,Nelson Marlborough,0,0,0,0,0,0,0,0
16/03/2020,Northland,0,0,0,0,0,0,0,0
16/03/2020,South Canterbury,0,0,0,0,0,0,0,0
16/03/2020,Southern,0,0,0,0,1,0,0,1
16/03/2020,Tairawhiti,0,0,0,0,0,0,0,0
16/03/2020,Taranaki,2,0,0,2,2,0,0,2
16/03/2020,Waikato,2,0,0,2,2,0,0,2
16/03/2020,Wairarapa,0,0,0,0,0,0,0,0
16/03/2020,Waitemata,0,0,0,0,3,1,0,4
16/03/2020,West Coast,0,0,0,0,0,0,0,0
16/03/2020,Whanganui,0,0,0,0,0,0,0,0
15/03/2020,Auckland,0,0,0,0,1,0,0,1
15/03/2020,Bay of Plenty,0,0,0,0,0,0,0,0
15/03/2020,Canterbury,0,0,0,0,0,0,0,0
15/03/2020,Capital and Coast,0,0,0,0,1,0,0,1
15/03/2020,Counties Manukau,0,0,0,0,3,1,0,4
15/03/2020,Hawke's Bay,0,0,0,0,0,0,0,0
15/03/2020,Hutt Valley,0,0,0,0,0,0,0,0
15/03/2020,Lakes,0,0,0,0,0,0,0,0
15/03/2020,Midcentral,0,0,0,0,0,0,0,0
15/03/2020,Nelson Marlborough,0,0,0,0,0,0,0,0
15/03/2020,Northland,0,0,0,0,0,0,0,0
15/03/2020,South Canterbury,0,0,0,0,0,0,0,0
15/03/2020,Southern,0,0,0,0,1,0,0,1
15/03/2020,Tairawhiti,0,0,0,0,0,0,0,0
15/03/2020,Taranaki,0,0,0,0,0,0,0,0
15/03/2020,Waikato,0,0,0,0,0,0,0,0
15/03/2020,Wairarapa,0,0,0,0,0,0,0,0
15/03/2020,Waitemata,1,0,0,1,3,1,0,4
15/03/2020,West Coast,0,0,0,0,0,0,0,0
15/03/2020,Whanganui,0,0,0,0,0,0,0,0
14/03/2020,Auckland,0,0,0,0,1,0,0,1
14/03/2020,Bay of Plenty,0,0,0,0,0,0,0,0
14/03/2020,Canterbury,0,0,0,0,0,0,0,0
14/03/2020,Capital and Coast,1,0,0,1,1,0,0,1
14/03/2020,Counties Manukau,0,0,0,0,3,1,0,4
14/03/2020,Hawke's Bay,0,0,0,0,0,0,0,0
14/03/2020,Hutt Valley,0,0,0,0,0,0,0,0
14/03/2020,Lakes,0,0,0,0,0,0,0,0
14/03/2020,Midcentral,0,0,0,0,0,0,0,0
14/03/2020,Nelson Marlborough,0,0,0,0,0,0,0,0
14/03/2020,Northland,0,0,0,0,0,0,0,0
14/03/2020,South Canterbury,0,0,0,0,0,0,0,0
14/03/2020,Southern,0,0,0,0,1,0,0,1
14/03/2020,Tairawhiti,0,0,0,0,0,0,0,0
14/03/2020,Taranaki,0,0,0,0,0,0,0,0
14/03/2020,Waikato,0,0,0,0,0,0,0,0
14/03/2020,Wairarapa,0,0,0,0,0,0,0,0
14/03/2020,Waitemata,0,0,0,0,2,1,0,3
14/03/2020,West Coast,0,0,0,0,0,0,0,0
14/03/2020,Whanganui,0,0,0,0,0,0,0,0
13/03/2020,Auckland,0,0,0,0,1,0,0,1
13/03/2020,Bay of Plenty,0,0,0,0,0,0,0,0
13/03/2020,Canterbury,0,0,0,0,0,0,0,0
13/03/2020,Capital and Coast,0,0,0,0,0,0,0,0
13/03/2020,Counties Manukau,0,0,0,0,3,1,0,4
13/03/2020,Hawke's Bay,0,0,0,0,0,0,0,0
13/03/2020,Hutt Valley,0,0,0,0,0,0,0,0
13/03/2020,Lakes,0,0,0,0,0,0,0,0
13/03/2020,Midcentral,0,0,0,0,0,0,0,0
13/03/2020,Nelson Marlborough,0,0,0,0,0,0,0,0
13/03/2020,Northland,0,0,0,0,0,0,0,0
13/03/2020,South Canterbury,0,0,0,0,0,0,0,0
13/03/2020,Southern,1,0,0,1,1,0,0,1
13/03/2020,Tairawhiti,0,0,0,0,0,0,0,0
13/03/2020,Taranaki,0,0,0,0,0,0,0,0
13/03/2020,Waikato,0,0,0,0,0,0,0,0
13/03/2020,Wairarapa,0,0,0,0,0,0,0,0
13/03/2020,Waitemata,0,0,0,0,2,1,0,3
13/03/2020,West Coast,0,0,0,0,0,0,0,0
13/03/2020,Whanganui,0,0,0,0,0,0,0,0
12/03/2020,Auckland,0,0,0,0,1,0,0,1
12/03/2020,Bay of Plenty,0,0,0,0,0,0,0,0
12/03/2020,Canterbury,0,0,0,0,0,0,0,0
12/03/2020,Capital and Coast,0,0,0,0,0,0,0,0
12/03/2020,Counties Manukau,1,0,0,1,3,1,0,4
12/03/2020,Hawke's Bay,0,0,0,0,0,0,0,0
12/03/2020,Hutt Valley,0,0,0,0,0,0,0,0
12/03/2020,Lakes,0,0,0,0,0,0,0,0
12/03/2020,Midcentral,0,0,0,0,0,0,0,0
12/03/2020,Nelson Marlborough,0,0,0,0,0,0,0,0
12/03/2020,Northland,0,0,0,0,0,0,0,0
12/03/2020,South Canterbury,0,0,0,0,0,0,0,0
12/03/2020,Southern,0,0,0,0,0,0,0,0
12/03/2020,Tairawhiti,0,0,0,0,0,0,0,0
12/03/2020,Taranaki,0,0,0,0,0,0,0,0
12/03/2020,Waikato,0,0,0,0,0,0,0,0
12/03/2020,Wairarapa,0,0,0,0,0,0,0,0
12/03/2020,Waitemata,0,0,0,0,2,1,0,3
12/03/2020,West Coast,0,0,0,0,0,0,0,0
12/03/2020,Whanganui,0,0,0,0,0,0,0,0
11/03/2020,Auckland,0,0,0,0,1,0,0,1
11/03/2020,Bay of Plenty,0,0,0,0,0,0,0,0
11/03/2020,Canterbury,0,0,0,0,0,0,0,0
11/03/2020,Capital and Coast,0,0,0,0,0,0,0,0
11/03/2020,Counties Manukau,0,0,0,0,2,1,0,3
11/03/2020,Hawke's Bay,0,0,0,0,0,0,0,0
11/03/2020,Hutt Valley,0,0,0,0,0,0,0,0
11/03/2020,Lakes,0,0,0,0,0,0,0,0
11/03/2020,Midcentral,0,0,0,0,0,0,0,0
11/03/2020,Nelson Marlborough,0,0,0,0,0,0,0,0
11/03/2020,Northland,0,0,0,0,0,0,0,0
11/03/2020,South Canterbury,0,0,0,0,0,0,0,0
11/03/2020,Southern,0,0,0,0,0,0,0,0
11/03/2020,Tairawhiti,0,0,0,0,0,0,0,0
11/03/2020,Taranaki,0,0,0,0,0,0,0,0
11/03/2020,Waikato,0,0,0,0,0,0,0,0
11/03/2020,Wairarapa,0,0,0,0,0,0,0,0
11/03/2020,Waitemata,0,0,0,0,2,1,0,3
11/03/2020,West Coast,0,0,0,0,0,0,0,0
11/03/2020,Whanganui,0,0,0,0,0,0,0,0
10/03/2020,Auckland,0,0,0,0,1,0,0,1
10/03/2020,Bay of Plenty,0,0,0,0,0,0,0,0
10/03/2020,Canterbury,0,0,0,0,0,0,0,0
10/03/2020,Capital and Coast,0,0,0,0,0,0,0,0
10/03/2020,Counties Manukau,0,0,0,0,2,1,0,3
10/03/2020,Hawke's Bay,0,0,0,0,0,0,0,0
10/03/2020,Hutt Valley,0,0,0,0,0,0,0,0
10/03/2020,Lakes,0,0,0,0,0,0,0,0
10/03/2020,Midcentral,0,0,0,0,0,0,0,0
10/03/2020,Nelson Marlborough,0,0,0,0,0,0,0,0
10/03/2020,Northland,0,0,0,0,0,0,0,0
10/03/2020,South Canterbury,0,0,0,0,0,0,0,0
10/03/2020,Southern,0,0,0,0,0,0,0,0
10/03/2020,Tairawhiti,0,0,0,0,0,0,0,0
10/03/2020,Taranaki,0,0,0,0,0,0,0,0
10/03/2020,Waikato,0,0,0,0,0,0,0,0
10/03/2020,Wairarapa,0,0,0,0,0,0,0,0
10/03/2020,Waitemata,0,0,0,0,2,1,0,3
10/03/2020,West Coast,0,0,0,0,0,0,0,0
10/03/2020,Whanganui,0,0,0,0,0,0,0,0
09/03/2020,Auckland,0,0,0,0,1,0,0,1
09/03/2020,Bay of Plenty,0,0,0,0,0,0,0,0
09/03/2020,Canterbury,0,0,0,0,0,0,0,0
09/03/2020,Capital and Coast,0,0,0,0,0,0,0,0
09/03/2020,Counties Manukau,0,0,0,0,2,1,0,3
09/03/2020,Hawke's Bay,0,0,0,0,0,0,0,0
09/03/2020,Hutt Valley,0,0,0,0,0,0,0,0
09/03/2020,Lakes,0,0,0,0,0,0,0,0
09/03/2020,Midcentral,0,0,0,0,0,0,0,0
09/03/2020,Nelson Marlborough,0,0,0,0,0,0,0,0
09/03/2020,Northland,0,0,0,0,0,0,0,0
09/03/2020,South Canterbury,0,0,0,0,0,0,0,0
09/03/2020,Southern,0,0,0,0,0,0,0,0
09/03/2020,Tairawhiti,0,0,0,0,0,0,0,0
09/03/2020,Taranaki,0,0,0,0,0,0,0,0
09/03/2020,Waikato,0,0,0,0,0,0,0,0
09/03/2020,Wairarapa,0,0,0,0,0,0,0,0
09/03/2020,Waitemata,0,0,0,0,2,1,0,3
09/03/2020,West Coast,0,0,0,0,0,0,0,0
09/03/2020,Whanganui,0,0,0,0,0,0,0,0
08/03/2020,Auckland,0,0,0,0,1,0,0,1
08/03/2020,Bay of Plenty,0,0,0,0,0,0,0,0
08/03/2020,Canterbury,0,0,0,0,0,0,0,0
08/03/2020,Capital and Coast,0,0,0,0,0,0,0,0
08/03/2020,Counties Manukau,0,0,0,0,2,1,0,3
08/03/2020,Hawke's Bay,0,0,0,0,0,0,0,0
08/03/2020,Hutt Valley,0,0,0,0,0,0,0,0
08/03/2020,Lakes,0,0,0,0,0,0,0,0
08/03/2020,Midcentral,0,0,0,0,0,0,0,0
08/03/2020,Nelson Marlborough,0,0,0,0,0,0,0,0
08/03/2020,Northland,0,0,0,0,0,0,0,0
08/03/2020,South Canterbury,0,0,0,0,0,0,0,0
08/03/2020,Southern,0,0,0,0,0,0,0,0
08/03/2020,Tairawhiti,0,0,0,0,0,0,0,0
08/03/2020,Taranaki,0,0,0,0,0,0,0,0
08/03/2020,Waikato,0,0,0,0,0,0,0,0
08/03/2020,Wairarapa,0,0,0,0,0,0,0,0
08/03/2020,Waitemata,0,0,0,0,2,1,0,3
08/03/2020,West Coast,0,0,0,0,0,0,0,0
08/03/2020,Whanganui,0,0,0,0,0,0,0,0
07/03/2020,Auckland,0,0,0,0,1,0,0,1
07/03/2020,Bay of Plenty,0,0,0,0,0,0,0,0
07/03/2020,Canterbury,0,0,0,0,0,0,0,0
07/03/2020,Capital and Coast,0,0,0,0,0,0,0,0
07/03/2020,Counties Manukau,0,0,0,0,2,1,0,3
07/03/2020,Hawke's Bay,0,0,0,0,0,0,0,0
07/03/2020,Hutt Valley,0,0,0,0,0,0,0,0
07/03/2020,Lakes,0,0,0,0,0,0,0,0
07/03/2020,Midcentral,0,0,0,0,0,0,0,0
07/03/2020,Nelson Marlborough,0,0,0,0,0,0,0,0
07/03/2020,Northland,0,0,0,0,0,0,0,0
07/03/2020,South Canterbury,0,0,0,0,0,0,0,0
07/03/2020,Southern,0,0,0,0,0,0,0,0
07/03/2020,Tairawhiti,0,0,0,0,0,0,0,0
07/03/2020,Taranaki,0,0,0,0,0,0,0,0
07/03/2020,Waikato,0,0,0,0,0,0,0,0
07/03/2020,Wairarapa,0,0,0,0,0,0,0,0
07/03/2020,Waitemata,0,0,0,0,2,1,0,3
07/03/2020,West Coast,0,0,0,0,0,0,0,0
07/03/2020,Whanganui,0,0,0,0,0,0,0,0
06/03/2020,Auckland,0,0,0,0,1,0,0,1
06/03/2020,Bay of Plenty,0,0,0,0,0,0,0,0
06/03/2020,Canterbury,0,0,0,0,0,0,0,0
06/03/2020,Capital and Coast,0,0,0,0,0,0,0,0
06/03/2020,Counties Manukau,1,0,0,1,2,1,0,3
06/03/2020,Hawke's Bay,0,0,0,0,0,0,0,0
06/03/2020,Hutt Valley,0,0,0,0,0,0,0,0
06/03/2020,Lakes,0,0,0,0,0,0,0,0
06/03/2020,Midcentral,0,0,0,0,0,0,0,0
06/03/2020,Nelson Marlborough,0,0,0,0,0,0,0,0
06/03/2020,Northland,0,0,0,0,0,0,0,0
06/03/2020,South Canterbury,0,0,0,0,0,0,0,0
06/03/2020,Southern,0,0,0,0,0,0,0,0
06/03/2020,Tairawhiti,0,0,0,0,0,0,0,0
06/03/2020,Taranaki,0,0,0,0,0,0,0,0
06/03/2020,Waikato,0,0,0,0,0,0,0,0
06/03/2020,Wairarapa,0,0,0,0,0,0,0,0
06/03/2020,Waitemata,0,0,0,0,2,1,0,3
06/03/2020,West Coast,0,0,0,0,0,0,0,0
06/03/2020,Whanganui,0,0,0,0,0,0,0,0
05/03/2020,Auckland,0,0,0,0,1,0,0,1
05/03/2020,Bay of Plenty,0,0,0,0,0,0,0,0
05/03/2020,Canterbury,0,0,0,0,0,0,0,0
05/03/2020,Capital and Coast,0,0,0,0,0,0,0,0
05/03/2020,Counties Manukau,0,1,0,1,1,1,0,2
05/03/2020,Hawke's Bay,0,0,0,0,0,0,0,0
05/03/2020,Hutt Valley,0,0,0,0,0,0,0,0
05/03/2020,Lakes,0,0,0,0,0,0,0,0
05/03/2020,Midcentral,0,0,0,0,0,0,0,0
05/03/2020,Nelson Marlborough,0,0,0,0,0,0,0,0
05/03/2020,Northland,0,0,0,0,0,0,0,0
05/03/2020,South Canterbury,0,0,0,0,0,0,0,0
05/03/2020,Southern,0,0,0,0,0,0,0,0
05/03/2020,Tairawhiti,0,0,0,0,0,0,0,0
05/03/2020,Taranaki,0,0,0,0,0,0,0,0
05/03/2020,Waikato,0,0,0,0,0,0,0,0
05/03/2020,Wairarapa,0,0,0,0,0,0,0,0
05/03/2020,Waitemata,0,1,0,1,2,1,0,3
05/03/2020,West Coast,0,0,0,0,0,0,0,0
05/03/2020,Whanganui,0,0,0,0,0,0,0,0
04/03/2020,Auckland,0,0,0,0,1,0,0,1
04/03/2020,Bay of Plenty,0,0,0,0,0,0,0,0
04/03/2020,Canterbury,0,0,0,0,0,0,0,0
04/03/2020,Capital and Coast,0,0,0,0,0,0,0,0
04/03/2020,Counties Manukau,1,0,0,1,1,0,0,1
04/03/2020,Hawke's Bay,0,0,0,0,0,0,0,0
04/03/2020,Hutt Valley,0,0,0,0,0,0,0,0
04/03/2020,Lakes,0,0,0,0,0,0,0,0
04/03/2020,Midcentral,0,0,0,0,0,0,0,0
04/03/2020,Nelson Marlborough,0,0,0,0,0,0,0,0
04/03/2020,Northland,0,0,0,0,0,0,0,0
04/03/2020,South Canterbury,0,0,0,0,0,0,0,0
04/03/2020,Southern,0,0,0,0,0,0,0,0
04/03/2020,Tairawhiti,0,0,0,0,0,0,0,0
04/03/2020,Taranaki,0,0,0,0,0,0,0,0
04/03/2020,Waikato,0,0,0,0,0,0,0,0
04/03/2020,Wairarapa,0,0,0,0,0,0,0,0
04/03/2020,Waitemata,1,0,0,1,2,0,0,2
04/03/2020,West Coast,0,0,0,0,0,0,0,0
04/03/2020,Whanganui,0,0,0,0,0,0,0,0
03/03/2020,Auckland,0,0,0,0,1,0,0,1
03/03/2020,Bay of Plenty,0,0,0,0,0,0,0,0
03/03/2020,Canterbury,0,0,0,0,0,0,0,0
03/03/2020,Capital and Coast,0,0,0,0,0,0,0,0
03/03/2020,Counties Manukau,0,0,0,0,0,0,0,0
03/03/2020,Hawke's Bay,0,0,0,0,0,0,0,0
03/03/2020,Hutt Valley,0,0,0,0,0,0,0,0
03/03/2020,Lakes,0,0,0,0,0,0,0,0
03/03/2020,Midcentral,0,0,0,0,0,0,0,0
03/03/2020,Nelson Marlborough,0,0,0,0,0,0,0,0
03/03/2020,Northland,0,0,0,0,0,0,0,0
03/03/2020,South Canterbury,0,0,0,0,0,0,0,0
03/03/2020,Southern,0,0,0,0,0,0,0,0
03/03/2020,Tairawhiti,0,0,0,0,0,0,0,0
03/03/2020,Taranaki,0,0,0,0,0,0,0,0
03/03/2020,Waikato,0,0,0,0,0,0,0,0
03/03/2020,Wairarapa,0,0,0,0,0,0,0,0
03/03/2020,Waitemata,0,0,0,0,1,0,0,1
03/03/2020,West Coast,0,0,0,0,0,0,0,0
03/03/2020,Whanganui,0,0,0,0,0,0,0,0
02/03/2020,Auckland,0,0,0,0,1,0,0,1
02/03/2020,Bay of Plenty,0,0,0,0,0,0,0,0
02/03/2020,Canterbury,0,0,0,0,0,0,0,0
02/03/2020,Capital and Coast,0,0,0,0,0,0,0,0
02/03/2020,Counties Manukau,0,0,0,0,0,0,0,0
02/03/2020,Hawke's Bay,0,0,0,0,0,0,0,0
02/03/2020,Hutt Valley,0,0,0,0,0,0,0,0
02/03/2020,Lakes,0,0,0,0,0,0,0,0
02/03/2020,Midcentral,0,0,0,0,0,0,0,0
02/03/2020,Nelson Marlborough,0,0,0,0,0,0,0,0
02/03/2020,Northland,0,0,0,0,0,0,0,0
02/03/2020,South Canterbury,0,0,0,0,0,0,0,0
02/03/2020,Southern,0,0,0,0,0,0,0,0
02/03/2020,Tairawhiti,0,0,0,0,0,0,0,0
02/03/2020,Taranaki,0,0,0,0,0,0,0,0
02/03/2020,Waikato,0,0,0,0,0,0,0,0
02/03/2020,Wairarapa,0,0,0,0,0,0,0,0
02/03/2020,Waitemata,1,0,0,1,1,0,0,1
02/03/2020,West Coast,0,0,0,0,0,0,0,0
02/03/2020,Whanganui,0,0,0,0,0,0,0,0
01/03/2020,Auckland,0,0,0,0,1,0,0,1
01/03/2020,Bay of Plenty,0,0,0,0,0,0,0,0
01/03/2020,Canterbury,0,0,0,0,0,0,0,0
01/03/2020,Capital and Coast,0,0,0,0,0,0,0,0
01/03/2020,Counties Manukau,0,0,0,0,0,0,0,0
01/03/2020,Hawke's Bay,0,0,0,0,0,0,0,0
01/03/2020,Hutt Valley,0,0,0,0,0,0,0,0
01/03/2020,Lakes,0,0,0,0,0,0,0,0
01/03/2020,Midcentral,0,0,0,0,0,0,0,0
01/03/2020,Nelson Marlborough,0,0,0,0,0,0,0,0
01/03/2020,Northland,0,0,0,0,0,0,0,0
01/03/2020,South Canterbury,0,0,0,0,0,0,0,0
01/03/2020,Southern,0,0,0,0,0,0,0,0
01/03/2020,Tairawhiti,0,0,0,0,0,0,0,0
01/03/2020,Taranaki,0,0,0,0,0,0,0,0
01/03/2020,Waikato,0,0,0,0,0,0,0,0
01/03/2020,Wairarapa,0,0,0,0,0,0,0,0
01/03/2020,Waitemata,0,0,0,0,0,0,0,0
01/03/2020,West Coast,0,0,0,0,0,0,0,0
01/03/2020,Whanganui,0,0,0,0,0,0,0,0
29/02/2020,Auckland,0,0,0,0,1,0,0,1
29/02/2020,Bay of Plenty,0,0,0,0,0,0,0,0
29/02/2020,Canterbury,0,0,0,0,0,0,0,0
29/02/2020,Capital and Coast,0,0,0,0,0,0,0,0
29/02/2020,Counties Manukau,0,0,0,0,0,0,0,0
29/02/2020,Hawke's Bay,0,0,0,0,0,0,0,0
29/02/2020,Hutt Valley,0,0,0,0,0,0,0,0
29/02/2020,Lakes,0,0,0,0,0,0,0,0
29/02/2020,Midcentral,0,0,0,0,0,0,0,0
29/02/2020,Nelson Marlborough,0,0,0,0,0,0,0,0
29/02/2020,Northland,0,0,0,0,0,0,0,0
29/02/2020,South Canterbury,0,0,0,0,0,0,0,0
29/02/2020,Southern,0,0,0,0,0,0,0,0
29/02/2020,Tairawhiti,0,0,0,0,0,0,0,0
29/02/2020,Taranaki,0,0,0,0,0,0,0,0
29/02/2020,Waikato,0,0,0,0,0,0,0,0
29/02/2020,Wairarapa,0,0,0,0,0,0,0,0
29/02/2020,Waitemata,0,0,0,0,0,0,0,0
29/02/2020,West Coast,0,0,0,0,0,0,0,0
29/02/2020,Whanganui,0,0,0,0,0,0,0,0
28/02/2020,Auckland,0,0,0,0,1,0,0,1
28/02/2020,Bay of Plenty,0,0,0,0,0,0,0,0
28/02/2020,Canterbury,0,0,0,0,0,0,0,0
28/02/2020,Capital and Coast,0,0,0,0,0,0,0,0
28/02/2020,Counties Manukau,0,0,0,0,0,0,0,0
28/02/2020,Hawke's Bay,0,0,0,0,0,0,0,0
28/02/2020,Hutt Valley,0,0,0,0,0,0,0,0
28/02/2020,Lakes,0,0,0,0,0,0,0,0
28/02/2020,Midcentral,0,0,0,0,0,0,0,0
28/02/2020,Nelson Marlborough,0,0,0,0,0,0,0,0
28/02/2020,Northland,0,0,0,0,0,0,0,0
28/02/2020,South Canterbury,0,0,0,0,0,0,0,0
28/02/2020,Southern,0,0,0,0,0,0,0,0
28/02/2020,Tairawhiti,0,0,0,0,0,0,0,0
28/02/2020,Taranaki,0,0,0,0,0,0,0,0
28/02/2020,Waikato,0,0,0,0,0,0,0,0
28/02/2020,Wairarapa,0,0,0,0,0,0,0,0
28/02/2020,Waitemata,0,0,0,0,0,0,0,0
28/02/2020,West Coast,0,0,0,0,0,0,0,0
28/02/2020,Whanganui,0,0,0,0,0,0,0,0
27/02/2020,Auckland,0,0,0,0,1,0,0,1
27/02/2020,Bay of Plenty,0,0,0,0,0,0,0,0
27/02/2020,Canterbury,0,0,0,0,0,0,0,0
27/02/2020,Capital and Coast,0,0,0,0,0,0,0,0
27/02/2020,Counties Manukau,0,0,0,0,0,0,0,0
27/02/2020,Hawke's Bay,0,0,0,0,0,0,0,0
27/02/2020,Hutt Valley,0,0,0,0,0,0,0,0
27/02/2020,Lakes,0,0,0,0,0,0,0,0
27/02/2020,Midcentral,0,0,0,0,0,0,0,0
27/02/2020,Nelson Marlborough,0,0,0,0,0,0,0,0
27/02/2020,Northland,0,0,0,0,0,0,0,0
27/02/2020,South Canterbury,0,0,0,0,0,0,0,0
27/02/2020,Southern,0,0,0,0,0,0,0,0
27/02/2020,Tairawhiti,0,0,0,0,0,0,0,0
27/02/2020,Taranaki,0,0,0,0,0,0,0,0
27/02/2020,Waikato,0,0,0,0,0,0,0,0
27/02/2020,Wairarapa,0,0,0,0,0,0,0,0
27/02/2020,Waitemata,0,0,0,0,0,0,0,0
27/02/2020,West Coast,0,0,0,0,0,0,0,0
27/02/2020,Whanganui,0,0,0,0,0,0,0,0
26/02/2020,Auckland,1,0,0,1,1,0,0,1
26/02/2020,Bay of Plenty,0,0,0,0,0,0,0,0
26/02/2020,Canterbury,0,0,0,0,0,0,0,0
26/02/2020,Capital and Coast,0,0,0,0,0,0,0,0
26/02/2020,Counties Manukau,0,0,0,0,0,0,0,0
26/02/2020,Hawke's Bay,0,0,0,0,0,0,0,0
26/02/2020,Hutt Valley,0,0,0,0,0,0,0,0
26/02/2020,Lakes,0,0,0,0,0,0,0,0
26/02/2020,Midcentral,0,0,0,0,0,0,0,0
26/02/2020,Nelson Marlborough,0,0,0,0,0,0,0,0
26/02/2020,Northland,0,0,0,0,0,0,0,0
26/02/2020,South Canterbury,0,0,0,0,0,0,0,0
26/02/2020,Southern,0,0,0,0,0,0,0,0
26/02/2020,Tairawhiti,0,0,0,0,0,0,0,0
26/02/2020,Taranaki,0,0,0,0,0,0,0,0
26/02/2020,Waikato,0,0,0,0,0,0,0,0
26/02/2020,Wairarapa,0,0,0,0,0,0,0,0
26/02/2020,Waitemata,0,0,0,0,0,0,0,0
26/02/2020,West Coast,0,0,0,0,0,0,0,0
26/02/2020,Whanganui,0,0,0,0,0,0,0,0
