Date,Region,Daily confirmed,Daily probable,Daily deceased,Daily total cases,Cumulative confirmed,Cumulative probable,Cumulative deceased,Cumulative total cases
2020-11-12,Auckland,0,0,0,0,278,51,1,329
2020-11-12,Bay of Plenty,0,0,0,0,34,14,0,48
2020-11-12,Canterbury,0,0,0,0,172,65,12,237
2020-11-12,Capital and Coast,0,0,0,0,74,24,2,98
2020-11-12,Counties Manukau,0,0,0,0,294,24,1,318
2020-11-12,Hawke's Bay,0,0,0,0,38,6,0,44
2020-11-12,Hutt Valley,0,0,0,0,20,3,0,23
2020-11-12,Lakes,0,0,0,0,15,1,0,16
2020-11-12,Midcentral,0,0,0,0,27,5,0,32
2020-11-12,Nelson Marlborough,0,0,0,0,38,12,0,50
2020-11-12,Northland,0,0,0,0,26,2,0,28
2020-11-12,South Canterbury,0,0,0,0,15,2,0,17
2020-11-12,Southern,0,0,0,0,186,30,2,216
2020-11-12,Tairawhiti,0,0,0,0,3,1,0,4
2020-11-12,Taranaki,0,0,0,0,14,2,0,16
2020-11-12,Waikato,0,0,0,0,155,39,2,194
2020-11-12,Wairarapa,0,0,0,0,6,2,0,8
2020-11-12,Waitemata,0,0,0,0,225,71,4,296
2020-11-12,West Coast,0,0,0,0,4,1,1,5
2020-11-12,Whanganui,0,0,0,0,8,1,0,9
2020-11-11,Auckland,0,0,0,0,278,51,1,329
2020-11-11,Bay of Plenty,0,0,0,0,34,14,0,48
2020-11-11,Canterbury,0,0,0,0,172,65,12,237
2020-11-11,Capital and Coast,0,0,0,0,74,24,2,98
2020-11-11,Counties Manukau,0,0,0,0,294,24,1,318
2020-11-11,Hawke's Bay,0,0,0,0,38,6,0,44
2020-11-11,Hutt Valley,0,0,0,0,20,3,0,23
2020-11-11,Lakes,0,0,0,0,15,1,0,16
2020-11-11,Midcentral,0,0,0,0,27,5,0,32
2020-11-11,Nelson Marlborough,0,0,0,0,38,12,0,50
2020-11-11,Northland,0,0,0,0,26,2,0,28
2020-11-11,South Canterbury,0,0,0,0,15,2,0,17
2020-11-11,Southern,0,0,0,0,186,30,2,216
2020-11-11,Tairawhiti,0,0,0,0,3,1,0,4
2020-11-11,Taranaki,0,0,0,0,14,2,0,16
2020-11-11,Waikato,0,0,0,0,155,39,2,194
2020-11-11,Wairarapa,0,0,0,0,6,2,0,8
2020-11-11,Waitemata,0,0,0,0,225,71,4,296
2020-11-11,West Coast,0,0,0,0,4,1,1,5
2020-11-11,Whanganui,0,0,0,0,8,1,0,9
2020-11-10,Auckland,0,0,0,0,278,51,1,329
2020-11-10,Bay of Plenty,0,0,0,0,34,14,0,48
2020-11-10,Canterbury,0,0,0,0,172,65,12,237
2020-11-10,Capital and Coast,0,0,0,0,74,24,2,98
2020-11-10,Counties Manukau,1,0,0,1,294,24,1,318
2020-11-10,Hawke's Bay,0,0,0,0,38,6,0,44
2020-11-10,Hutt Valley,0,0,0,0,20,3,0,23
2020-11-10,Lakes,0,0,0,0,15,1,0,16
2020-11-10,Midcentral,0,0,0,0,27,5,0,32
2020-11-10,Nelson Marlborough,0,0,0,0,38,12,0,50
2020-11-10,Northland,0,0,0,0,26,2,0,28
2020-11-10,South Canterbury,0,0,0,0,15,2,0,17
2020-11-10,Southern,0,0,0,0,186,30,2,216
2020-11-10,Tairawhiti,0,0,0,0,3,1,0,4
2020-11-10,Taranaki,0,0,0,0,14,2,0,16
2020-11-10,Waikato,0,0,0,0,155,39,2,194
2020-11-10,Wairarapa,0,0,0,0,6,2,0,8
2020-11-10,Waitemata,0,0,0,0,225,71,4,296
2020-11-10,West Coast,0,0,0,0,4,1,1,5
2020-11-10,Whanganui,0,0,0,0,8,1,0,9
2020-11-09,Auckland,2,0,0,2,278,51,1,329
2020-11-09,Bay of Plenty,0,0,0,0,34,14,0,48
2020-11-09,Canterbury,0,0,0,0,172,65,12,237
2020-11-09,Capital and Coast,0,0,0,0,74,24,2,98
2020-11-09,Counties Manukau,2,0,0,2,293,24,1,317
2020-11-09,Hawke's Bay,0,0,0,0,38,6,0,44
2020-11-09,Hutt Valley,0,0,0,0,20,3,0,23
2020-11-09,Lakes,0,0,0,0,15,1,0,16
2020-11-09,Midcentral,0,0,0,0,27,5,0,32
2020-11-09,Nelson Marlborough,0,0,0,0,38,12,0,50
2020-11-09,Northland,0,0,0,0,26,2,0,28
2020-11-09,South Canterbury,0,0,0,0,15,2,0,17
2020-11-09,Southern,0,0,0,0,186,30,2,216
2020-11-09,Tairawhiti,0,0,0,0,3,1,0,4
2020-11-09,Taranaki,0,0,0,0,14,2,0,16
2020-11-09,Waikato,0,0,0,0,155,39,2,194
2020-11-09,Wairarapa,0,0,0,0,6,2,0,8
2020-11-09,Waitemata,0,0,0,0,225,71,4,296
2020-11-09,West Coast,0,0,0,0,4,1,1,5
2020-11-09,Whanganui,0,0,0,0,8,1,0,9
2020-11-08,Auckland,1,0,0,1,276,51,1,327
2020-11-08,Bay of Plenty,0,0,0,0,34,14,0,48
2020-11-08,Canterbury,0,0,0,0,172,65,12,237
2020-11-08,Capital and Coast,0,0,0,0,74,24,2,98
2020-11-08,Counties Manukau,0,0,0,0,291,24,1,315
2020-11-08,Hawke's Bay,0,0,0,0,38,6,0,44
2020-11-08,Hutt Valley,0,0,0,0,20,3,0,23
2020-11-08,Lakes,0,0,0,0,15,1,0,16
2020-11-08,Midcentral,0,0,0,0,27,5,0,32
2020-11-08,Nelson Marlborough,0,0,0,0,38,12,0,50
2020-11-08,Northland,0,0,0,0,26,2,0,28
2020-11-08,South Canterbury,0,0,0,0,15,2,0,17
2020-11-08,Southern,0,0,0,0,186,30,2,216
2020-11-08,Tairawhiti,0,0,0,0,3,1,0,4
2020-11-08,Taranaki,0,0,0,0,14,2,0,16
2020-11-08,Waikato,0,0,0,0,155,39,2,194
2020-11-08,Wairarapa,0,0,0,0,6,2,0,8
2020-11-08,Waitemata,0,0,0,0,225,71,4,296
2020-11-08,West Coast,0,0,0,0,4,1,1,5
2020-11-08,Whanganui,0,0,0,0,8,1,0,9
2020-11-07,Auckland,4,0,0,4,275,51,1,326
2020-11-07,Bay of Plenty,0,0,0,0,34,14,0,48
2020-11-07,Canterbury,0,0,0,0,172,65,12,237
2020-11-07,Capital and Coast,0,0,0,0,74,24,2,98
2020-11-07,Counties Manukau,1,0,0,1,291,24,1,315
2020-11-07,Hawke's Bay,0,0,0,0,38,6,0,44
2020-11-07,Hutt Valley,1,0,0,1,20,3,0,23
2020-11-07,Lakes,0,0,0,0,15,1,0,16
2020-11-07,Midcentral,0,0,0,0,27,5,0,32
2020-11-07,Nelson Marlborough,0,0,0,0,38,12,0,50
2020-11-07,Northland,0,0,0,0,26,2,0,28
2020-11-07,South Canterbury,0,0,0,0,15,2,0,17
2020-11-07,Southern,0,0,0,0,186,30,2,216
2020-11-07,Tairawhiti,0,0,0,0,3,1,0,4
2020-11-07,Taranaki,0,0,0,0,14,2,0,16
2020-11-07,Waikato,0,0,0,0,155,39,2,194
2020-11-07,Wairarapa,0,0,0,0,6,2,0,8
2020-11-07,Waitemata,0,0,0,0,225,71,4,296
2020-11-07,West Coast,0,0,0,0,4,1,1,5
2020-11-07,Whanganui,0,0,0,0,8,1,0,9
2020-11-06,Auckland,1,0,0,1,271,51,1,322
2020-11-06,Bay of Plenty,0,0,0,0,34,14,0,48
2020-11-06,Canterbury,0,0,0,0,172,65,12,237
2020-11-06,Capital and Coast,0,0,0,0,74,24,2,98
2020-11-06,Counties Manukau,0,0,0,0,290,24,1,314
2020-11-06,Hawke's Bay,0,0,0,0,38,6,0,44
2020-11-06,Hutt Valley,0,0,0,0,19,3,0,22
2020-11-06,Lakes,0,0,0,0,15,1,0,16
2020-11-06,Midcentral,0,0,0,0,27,5,0,32
2020-11-06,Nelson Marlborough,0,0,0,0,38,12,0,50
2020-11-06,Northland,0,0,0,0,26,2,0,28
2020-11-06,South Canterbury,0,0,0,0,15,2,0,17
2020-11-06,Southern,0,0,0,0,186,30,2,216
2020-11-06,Tairawhiti,0,0,0,0,3,1,0,4
2020-11-06,Taranaki,0,0,0,0,14,2,0,16
2020-11-06,Waikato,0,0,0,0,155,39,2,194
2020-11-06,Wairarapa,0,0,0,0,6,2,0,8
2020-11-06,Waitemata,0,0,0,0,225,71,4,296
2020-11-06,West Coast,0,0,0,0,4,1,1,5
2020-11-06,Whanganui,0,0,0,0,8,1,0,9
2020-11-05,Auckland,1,0,0,1,270,51,1,321
2020-11-05,Bay of Plenty,0,0,0,0,34,14,0,48
2020-11-05,Canterbury,0,0,0,0,172,65,12,237
2020-11-05,Capital and Coast,0,0,0,0,74,24,2,98
2020-11-05,Counties Manukau,0,0,0,0,290,24,1,314
2020-11-05,Hawke's Bay,0,0,0,0,38,6,0,44
2020-11-05,Hutt Valley,0,0,0,0,19,3,0,22
2020-11-05,Lakes,0,0,0,0,15,1,0,16
2020-11-05,Midcentral,0,0,0,0,27,5,0,32
2020-11-05,Nelson Marlborough,0,0,0,0,38,12,0,50
2020-11-05,Northland,0,0,0,0,26,2,0,28
2020-11-05,South Canterbury,0,0,0,0,15,2,0,17
2020-11-05,Southern,0,0,0,0,186,30,2,216
2020-11-05,Tairawhiti,0,0,0,0,3,1,0,4
2020-11-05,Taranaki,0,0,0,0,14,2,0,16
2020-11-05,Waikato,0,0,0,0,155,39,2,194
2020-11-05,Wairarapa,0,0,0,0,6,2,0,8
2020-11-05,Waitemata,0,0,0,0,225,71,4,296
2020-11-05,West Coast,0,0,0,0,4,1,1,5
2020-11-05,Whanganui,0,0,0,0,8,1,0,9
2020-11-04,Auckland,2,0,0,2,269,51,1,320
2020-11-04,Bay of Plenty,0,0,0,0,34,14,0,48
2020-11-04,Canterbury,0,0,0,0,172,65,12,237
2020-11-04,Capital and Coast,0,0,0,0,74,24,2,98
2020-11-04,Counties Manukau,1,0,0,1,290,24,1,314
2020-11-04,Hawke's Bay,0,0,0,0,38,6,0,44
2020-11-04,Hutt Valley,0,0,0,0,19,3,0,22
2020-11-04,Lakes,0,0,0,0,15,1,0,16
2020-11-04,Midcentral,0,0,0,0,27,5,0,32
2020-11-04,Nelson Marlborough,0,0,0,0,38,12,0,50
2020-11-04,Northland,0,0,0,0,26,2,0,28
2020-11-04,South Canterbury,0,0,0,0,15,2,0,17
2020-11-04,Southern,0,0,0,0,186,30,2,216
2020-11-04,Tairawhiti,0,0,0,0,3,1,0,4
2020-11-04,Taranaki,0,0,0,0,14,2,0,16
2020-11-04,Waikato,0,0,0,0,155,39,2,194
2020-11-04,Wairarapa,0,0,0,0,6,2,0,8
2020-11-04,Waitemata,0,0,0,0,225,71,4,296
2020-11-04,West Coast,0,0,0,0,4,1,1,5
2020-11-04,Whanganui,0,0,0,0,8,1,0,9
2020-11-03,Auckland,0,0,0,0,267,51,1,318
2020-11-03,Bay of Plenty,0,0,0,0,34,14,0,48
2020-11-03,Canterbury,1,0,0,1,172,65,12,237
2020-11-03,Capital and Coast,0,0,0,0,74,24,2,98
2020-11-03,Counties Manukau,0,0,0,0,289,24,1,313
2020-11-03,Hawke's Bay,0,0,0,0,38,6,0,44
2020-11-03,Hutt Valley,0,0,0,0,19,3,0,22
2020-11-03,Lakes,0,0,0,0,15,1,0,16
2020-11-03,Midcentral,0,0,0,0,27,5,0,32
2020-11-03,Nelson Marlborough,0,0,0,0,38,12,0,50
2020-11-03,Northland,0,0,0,0,26,2,0,28
2020-11-03,South Canterbury,0,0,0,0,15,2,0,17
2020-11-03,Southern,0,0,0,0,186,30,2,216
2020-11-03,Tairawhiti,0,0,0,0,3,1,0,4
2020-11-03,Taranaki,0,0,0,0,14,2,0,16
2020-11-03,Waikato,0,0,0,0,155,39,2,194
2020-11-03,Wairarapa,0,0,0,0,6,2,0,8
2020-11-03,Waitemata,0,0,0,0,225,71,4,296
2020-11-03,West Coast,0,0,0,0,4,1,1,5
2020-11-03,Whanganui,0,0,0,0,8,1,0,9
2020-11-02,Auckland,0,0,0,0,267,51,1,318
2020-11-02,Bay of Plenty,0,0,0,0,34,14,0,48
2020-11-02,Canterbury,1,0,0,1,171,65,12,236
2020-11-02,Capital and Coast,0,0,0,0,74,24,2,98
2020-11-02,Counties Manukau,4,0,0,4,289,24,1,313
2020-11-02,Hawke's Bay,0,0,0,0,38,6,0,44
2020-11-02,Hutt Valley,0,0,0,0,19,3,0,22
2020-11-02,Lakes,0,0,0,0,15,1,0,16
2020-11-02,Midcentral,0,0,0,0,27,5,0,32
2020-11-02,Nelson Marlborough,0,0,0,0,38,12,0,50
2020-11-02,Northland,0,0,0,0,26,2,0,28
2020-11-02,South Canterbury,0,0,0,0,15,2,0,17
2020-11-02,Southern,0,0,0,0,186,30,2,216
2020-11-02,Tairawhiti,0,0,0,0,3,1,0,4
2020-11-02,Taranaki,0,0,0,0,14,2,0,16
2020-11-02,Waikato,0,0,0,0,155,39,2,194
2020-11-02,Wairarapa,0,0,0,0,6,2,0,8
2020-11-02,Waitemata,0,0,0,0,225,71,4,296
2020-11-02,West Coast,0,0,0,0,4,1,1,5
2020-11-02,Whanganui,0,0,0,0,8,1,0,9
2020-11-01,Auckland,1,0,0,1,267,51,1,318
2020-11-01,Bay of Plenty,0,0,0,0,34,14,0,48
2020-11-01,Canterbury,1,0,0,1,170,65,12,235
2020-11-01,Capital and Coast,0,0,0,0,74,24,2,98
2020-11-01,Counties Manukau,1,0,0,1,285,24,1,309
2020-11-01,Hawke's Bay,0,0,0,0,38,6,0,44
2020-11-01,Hutt Valley,0,0,0,0,19,3,0,22
2020-11-01,Lakes,0,0,0,0,15,1,0,16
2020-11-01,Midcentral,0,0,0,0,27,5,0,32
2020-11-01,Nelson Marlborough,0,0,0,0,38,12,0,50
2020-11-01,Northland,0,0,0,0,26,2,0,28
2020-11-01,South Canterbury,0,0,0,0,15,2,0,17
2020-11-01,Southern,0,0,0,0,186,30,2,216
2020-11-01,Tairawhiti,0,0,0,0,3,1,0,4
2020-11-01,Taranaki,0,0,0,0,14,2,0,16
2020-11-01,Waikato,0,0,0,0,155,39,2,194
2020-11-01,Wairarapa,0,0,0,0,6,2,0,8
2020-11-01,Waitemata,0,0,0,0,225,71,4,296
2020-11-01,West Coast,0,0,0,0,4,1,1,5
2020-11-01,Whanganui,0,0,0,0,8,1,0,9
2020-10-31,Auckland,2,0,0,2,266,51,1,317
2020-10-31,Bay of Plenty,0,0,0,0,34,14,0,48
2020-10-31,Canterbury,0,0,0,0,169,65,12,234
2020-10-31,Capital and Coast,0,0,0,0,74,24,2,98
2020-10-31,Counties Manukau,2,0,0,2,284,24,1,308
2020-10-31,Hawke's Bay,0,0,0,0,38,6,0,44
2020-10-31,Hutt Valley,0,0,0,0,19,3,0,22
2020-10-31,Lakes,0,0,0,0,15,1,0,16
2020-10-31,Midcentral,0,0,0,0,27,5,0,32
2020-10-31,Nelson Marlborough,1,0,0,1,38,12,0,50
2020-10-31,Northland,0,0,0,0,26,2,0,28
2020-10-31,South Canterbury,0,0,0,0,15,2,0,17
2020-10-31,Southern,0,0,0,0,186,30,2,216
2020-10-31,Tairawhiti,0,0,0,0,3,1,0,4
2020-10-31,Taranaki,0,0,0,0,14,2,0,16
2020-10-31,Waikato,0,0,0,0,155,39,2,194
2020-10-31,Wairarapa,0,0,0,0,6,2,0,8
2020-10-31,Waitemata,0,0,0,0,225,71,4,296
2020-10-31,West Coast,0,0,0,0,4,1,1,5
2020-10-31,Whanganui,0,0,0,0,8,1,0,9
2020-10-30,Auckland,1,0,0,1,264,51,1,315
2020-10-30,Bay of Plenty,0,0,0,0,34,14,0,48
2020-10-30,Canterbury,0,0,0,0,169,65,12,234
2020-10-30,Capital and Coast,0,0,0,0,74,24,2,98
2020-10-30,Counties Manukau,5,0,0,5,282,24,1,306
2020-10-30,Hawke's Bay,0,0,0,0,38,6,0,44
2020-10-30,Hutt Valley,0,0,0,0,19,3,0,22
2020-10-30,Lakes,0,0,0,0,15,1,0,16
2020-10-30,Midcentral,0,0,0,0,27,5,0,32
2020-10-30,Nelson Marlborough,0,0,0,0,37,12,0,49
2020-10-30,Northland,0,0,0,0,26,2,0,28
2020-10-30,South Canterbury,0,0,0,0,15,2,0,17
2020-10-30,Southern,0,0,0,0,186,30,2,216
2020-10-30,Tairawhiti,0,0,0,0,3,1,0,4
2020-10-30,Taranaki,0,0,0,0,14,2,0,16
2020-10-30,Waikato,0,0,0,0,155,39,2,194
2020-10-30,Wairarapa,0,0,0,0,6,2,0,8
2020-10-30,Waitemata,0,0,0,0,225,71,4,296
2020-10-30,West Coast,0,0,0,0,4,1,1,5
2020-10-30,Whanganui,0,0,0,0,8,1,0,9
2020-10-29,Auckland,0,0,0,0,263,51,1,314
2020-10-29,Bay of Plenty,0,0,0,0,34,14,0,48
2020-10-29,Canterbury,1,0,0,1,169,65,12,234
2020-10-29,Capital and Coast,0,0,0,0,74,24,2,98
2020-10-29,Counties Manukau,0,0,0,0,277,24,1,301
2020-10-29,Hawke's Bay,0,0,0,0,38,6,0,44
2020-10-29,Hutt Valley,0,0,0,0,19,3,0,22
2020-10-29,Lakes,0,0,0,0,15,1,0,16
2020-10-29,Midcentral,0,0,0,0,27,5,0,32
2020-10-29,Nelson Marlborough,0,0,0,0,37,12,0,49
2020-10-29,Northland,0,0,0,0,26,2,0,28
2020-10-29,South Canterbury,0,0,0,0,15,2,0,17
2020-10-29,Southern,0,0,0,0,186,30,2,216
2020-10-29,Tairawhiti,0,0,0,0,3,1,0,4
2020-10-29,Taranaki,0,0,0,0,14,2,0,16
2020-10-29,Waikato,0,0,0,0,155,39,2,194
2020-10-29,Wairarapa,0,0,0,0,6,2,0,8
2020-10-29,Waitemata,0,0,0,0,225,71,4,296
2020-10-29,West Coast,0,0,0,0,4,1,1,5
2020-10-29,Whanganui,0,0,0,0,8,1,0,9
2020-10-28,Auckland,5,0,0,5,263,51,1,314
2020-10-28,Bay of Plenty,0,0,0,0,34,14,0,48
2020-10-28,Canterbury,0,0,0,0,168,65,12,233
2020-10-28,Capital and Coast,0,0,0,0,74,24,2,98
2020-10-28,Counties Manukau,1,0,0,1,277,24,1,301
2020-10-28,Hawke's Bay,0,0,0,0,38,6,0,44
2020-10-28,Hutt Valley,0,0,0,0,19,3,0,22
2020-10-28,Lakes,0,0,0,0,15,1,0,16
2020-10-28,Midcentral,0,0,0,0,27,5,0,32
2020-10-28,Nelson Marlborough,0,0,0,0,37,12,0,49
2020-10-28,Northland,0,0,0,0,26,2,0,28
2020-10-28,South Canterbury,0,0,0,0,15,2,0,17
2020-10-28,Southern,0,0,0,0,186,30,2,216
2020-10-28,Tairawhiti,0,0,0,0,3,1,0,4
2020-10-28,Taranaki,0,0,0,0,14,2,0,16
2020-10-28,Waikato,0,0,0,0,155,39,2,194
2020-10-28,Wairarapa,0,0,0,0,6,2,0,8
2020-10-28,Waitemata,0,0,0,0,225,71,4,296
2020-10-28,West Coast,0,0,0,0,4,1,1,5
2020-10-28,Whanganui,0,0,0,0,8,1,0,9
2020-10-27,Auckland,2,0,0,2,258,51,1,309
2020-10-27,Bay of Plenty,0,0,0,0,34,14,0,48
2020-10-27,Canterbury,0,0,0,0,168,65,12,233
2020-10-27,Capital and Coast,0,0,0,0,74,24,2,98
2020-10-27,Counties Manukau,1,0,0,1,276,24,1,300
2020-10-27,Hawke's Bay,0,0,0,0,38,6,0,44
2020-10-27,Hutt Valley,0,0,0,0,19,3,0,22
2020-10-27,Lakes,0,0,0,0,15,1,0,16
2020-10-27,Midcentral,0,0,0,0,27,5,0,32
2020-10-27,Nelson Marlborough,0,0,0,0,37,12,0,49
2020-10-27,Northland,0,0,0,0,26,2,0,28
2020-10-27,South Canterbury,0,0,0,0,15,2,0,17
2020-10-27,Southern,0,0,0,0,186,30,2,216
2020-10-27,Tairawhiti,0,0,0,0,3,1,0,4
2020-10-27,Taranaki,0,0,0,0,14,2,0,16
2020-10-27,Waikato,0,0,0,0,155,39,2,194
2020-10-27,Wairarapa,0,0,0,0,6,2,0,8
2020-10-27,Waitemata,0,0,0,0,225,71,4,296
2020-10-27,West Coast,0,0,0,0,4,1,1,5
2020-10-27,Whanganui,0,0,0,0,8,1,0,9
2020-10-26,Auckland,0,0,0,0,256,51,1,307
2020-10-26,Bay of Plenty,0,0,0,0,34,14,0,48
2020-10-26,Canterbury,0,0,0,0,168,65,12,233
2020-10-26,Capital and Coast,0,0,0,0,74,24,2,98
2020-10-26,Counties Manukau,1,0,0,1,275,24,1,299
2020-10-26,Hawke's Bay,0,0,0,0,38,6,0,44
2020-10-26,Hutt Valley,0,0,0,0,19,3,0,22
2020-10-26,Lakes,0,0,0,0,15,1,0,16
2020-10-26,Midcentral,0,0,0,0,27,5,0,32
2020-10-26,Nelson Marlborough,0,0,0,0,37,12,0,49
2020-10-26,Northland,0,0,0,0,26,2,0,28
2020-10-26,South Canterbury,0,0,0,0,15,2,0,17
2020-10-26,Southern,0,0,0,0,186,30,2,216
2020-10-26,Tairawhiti,0,0,0,0,3,1,0,4
2020-10-26,Taranaki,0,0,0,0,14,2,0,16
2020-10-26,Waikato,0,0,0,0,155,39,2,194
2020-10-26,Wairarapa,0,0,0,0,6,2,0,8
2020-10-26,Waitemata,0,0,0,0,225,71,4,296
2020-10-26,West Coast,0,0,0,0,4,1,1,5
2020-10-26,Whanganui,0,0,0,0,8,1,0,9
2020-10-25,Auckland,1,0,0,1,256,51,1,307
2020-10-25,Bay of Plenty,0,0,0,0,34,14,0,48
2020-10-25,Canterbury,3,0,0,3,168,65,12,233
2020-10-25,Capital and Coast,0,0,0,0,74,24,2,98
2020-10-25,Counties Manukau,0,0,0,0,274,24,1,298
2020-10-25,Hawke's Bay,0,0,0,0,38,6,0,44
2020-10-25,Hutt Valley,0,0,0,0,19,3,0,22
2020-10-25,Lakes,0,0,0,0,15,1,0,16
2020-10-25,Midcentral,0,0,0,0,27,5,0,32
2020-10-25,Nelson Marlborough,0,0,0,0,37,12,0,49
2020-10-25,Northland,0,0,0,0,26,2,0,28
2020-10-25,South Canterbury,0,0,0,0,15,2,0,17
2020-10-25,Southern,0,0,0,0,186,30,2,216
2020-10-25,Tairawhiti,0,0,0,0,3,1,0,4
2020-10-25,Taranaki,0,0,0,0,14,2,0,16
2020-10-25,Waikato,0,0,0,0,155,39,2,194
2020-10-25,Wairarapa,0,0,0,0,6,2,0,8
2020-10-25,Waitemata,0,0,0,0,225,71,4,296
2020-10-25,West Coast,0,0,0,0,4,1,1,5
2020-10-25,Whanganui,0,0,0,0,8,1,0,9
2020-10-24,Auckland,0,0,0,0,255,51,1,306
2020-10-24,Bay of Plenty,0,0,0,0,34,14,0,48
2020-10-24,Canterbury,0,0,0,0,165,65,12,230
2020-10-24,Capital and Coast,0,0,0,0,74,24,2,98
2020-10-24,Counties Manukau,0,0,0,0,274,24,1,298
2020-10-24,Hawke's Bay,0,0,0,0,38,6,0,44
2020-10-24,Hutt Valley,0,0,0,0,19,3,0,22
2020-10-24,Lakes,0,0,0,0,15,1,0,16
2020-10-24,Midcentral,0,0,0,0,27,5,0,32
2020-10-24,Nelson Marlborough,0,0,0,0,37,12,0,49
2020-10-24,Northland,0,0,0,0,26,2,0,28
2020-10-24,South Canterbury,0,0,0,0,15,2,0,17
2020-10-24,Southern,0,0,0,0,186,30,2,216
2020-10-24,Tairawhiti,0,0,0,0,3,1,0,4
2020-10-24,Taranaki,0,0,0,0,14,2,0,16
2020-10-24,Waikato,0,0,0,0,155,39,2,194
2020-10-24,Wairarapa,0,0,0,0,6,2,0,8
2020-10-24,Waitemata,0,0,0,0,225,71,4,296
2020-10-24,West Coast,0,0,0,0,4,1,1,5
2020-10-24,Whanganui,0,0,0,0,8,1,0,9
2020-10-23,Auckland,4,0,0,4,255,51,1,306
2020-10-23,Bay of Plenty,0,0,0,0,34,14,0,48
2020-10-23,Canterbury,12,0,0,12,165,65,12,230
2020-10-23,Capital and Coast,0,0,0,0,74,24,2,98
2020-10-23,Counties Manukau,2,0,0,2,274,24,1,298
2020-10-23,Hawke's Bay,0,0,0,0,38,6,0,44
2020-10-23,Hutt Valley,0,0,0,0,19,3,0,22
2020-10-23,Lakes,0,0,0,0,15,1,0,16
2020-10-23,Midcentral,0,0,0,0,27,5,0,32
2020-10-23,Nelson Marlborough,0,0,0,0,37,12,0,49
2020-10-23,Northland,0,0,0,0,26,2,0,28
2020-10-23,South Canterbury,0,0,0,0,15,2,0,17
2020-10-23,Southern,0,0,0,0,186,30,2,216
2020-10-23,Tairawhiti,0,0,0,0,3,1,0,4
2020-10-23,Taranaki,0,0,0,0,14,2,0,16
2020-10-23,Waikato,0,0,0,0,155,39,2,194
2020-10-23,Wairarapa,0,0,0,0,6,2,0,8
2020-10-23,Waitemata,0,0,0,0,225,71,4,296
2020-10-23,West Coast,0,0,0,0,4,1,1,5
2020-10-23,Whanganui,0,0,0,0,8,1,0,9
2020-10-22,Auckland,0,0,0,0,251,51,1,302
2020-10-22,Bay of Plenty,0,0,0,0,34,14,0,48
2020-10-22,Canterbury,0,0,0,0,153,65,12,218
2020-10-22,Capital and Coast,0,0,0,0,74,24,2,98
2020-10-22,Counties Manukau,2,0,0,2,272,24,1,296
2020-10-22,Hawke's Bay,0,0,0,0,38,6,0,44
2020-10-22,Hutt Valley,0,0,0,0,19,3,0,22
2020-10-22,Lakes,0,0,0,0,15,1,0,16
2020-10-22,Midcentral,0,0,0,0,27,5,0,32
2020-10-22,Nelson Marlborough,0,0,0,0,37,12,0,49
2020-10-22,Northland,0,0,0,0,26,2,0,28
2020-10-22,South Canterbury,0,0,0,0,15,2,0,17
2020-10-22,Southern,0,0,0,0,186,30,2,216
2020-10-22,Tairawhiti,0,0,0,0,3,1,0,4
2020-10-22,Taranaki,0,0,0,0,14,2,0,16
2020-10-22,Waikato,0,0,0,0,155,39,2,194
2020-10-22,Wairarapa,0,0,0,0,6,2,0,8
2020-10-22,Waitemata,1,0,0,1,225,71,4,296
2020-10-22,West Coast,0,0,0,0,4,1,1,5
2020-10-22,Whanganui,0,0,0,0,8,1,0,9
2020-10-21,Auckland,0,0,0,0,251,51,1,302
2020-10-21,Bay of Plenty,0,0,0,0,34,14,0,48
2020-10-21,Canterbury,0,0,0,0,153,65,12,218
2020-10-21,Capital and Coast,0,0,0,0,74,24,2,98
2020-10-21,Counties Manukau,3,0,0,3,270,24,1,294
2020-10-21,Hawke's Bay,0,0,0,0,38,6,0,44
2020-10-21,Hutt Valley,0,0,0,0,19,3,0,22
2020-10-21,Lakes,0,0,0,0,15,1,0,16
2020-10-21,Midcentral,0,0,0,0,27,5,0,32
2020-10-21,Nelson Marlborough,0,0,0,0,37,12,0,49
2020-10-21,Northland,0,0,0,0,26,2,0,28
2020-10-21,South Canterbury,0,0,0,0,15,2,0,17
2020-10-21,Southern,0,0,0,0,186,30,2,216
2020-10-21,Tairawhiti,0,0,0,0,3,1,0,4
2020-10-21,Taranaki,0,0,0,0,14,2,0,16
2020-10-21,Waikato,0,0,0,0,155,39,2,194
2020-10-21,Wairarapa,0,0,0,0,6,2,0,8
2020-10-21,Waitemata,1,0,0,1,224,71,4,295
2020-10-21,West Coast,0,0,0,0,4,1,1,5
2020-10-21,Whanganui,0,0,0,0,8,1,0,9
2020-10-20,Auckland,1,0,0,1,251,51,1,302
2020-10-20,Bay of Plenty,0,0,0,0,34,14,0,48
2020-10-20,Canterbury,21,0,0,21,153,65,12,218
2020-10-20,Capital and Coast,0,0,0,0,74,24,2,98
2020-10-20,Counties Manukau,0,0,0,0,267,24,1,291
2020-10-20,Hawke's Bay,0,0,0,0,38,6,0,44
2020-10-20,Hutt Valley,0,0,0,0,19,3,0,22
2020-10-20,Lakes,0,0,0,0,15,1,0,16
2020-10-20,Midcentral,0,0,0,0,27,5,0,32
2020-10-20,Nelson Marlborough,0,0,0,0,37,12,0,49
2020-10-20,Northland,0,0,0,0,26,2,0,28
2020-10-20,South Canterbury,0,0,0,0,15,2,0,17
2020-10-20,Southern,0,0,0,0,186,30,2,216
2020-10-20,Tairawhiti,0,0,0,0,3,1,0,4
2020-10-20,Taranaki,0,0,0,0,14,2,0,16
2020-10-20,Waikato,0,0,0,0,155,39,2,194
2020-10-20,Wairarapa,0,0,0,0,6,2,0,8
2020-10-20,Waitemata,0,0,0,0,223,71,4,294
2020-10-20,West Coast,0,0,0,0,4,1,1,5
2020-10-20,Whanganui,0,0,0,0,8,1,0,9
2020-10-19,Auckland,1,0,0,1,250,51,1,301
2020-10-19,Bay of Plenty,0,0,0,0,34,14,0,48
2020-10-19,Canterbury,0,0,0,0,132,65,12,197
2020-10-19,Capital and Coast,0,0,0,0,74,24,2,98
2020-10-19,Counties Manukau,0,0,0,0,267,24,1,291
2020-10-19,Hawke's Bay,0,0,0,0,38,6,0,44
2020-10-19,Hutt Valley,0,0,0,0,19,3,0,22
2020-10-19,Lakes,0,0,0,0,15,1,0,16
2020-10-19,Midcentral,0,0,0,0,27,5,0,32
2020-10-19,Nelson Marlborough,0,0,0,0,37,12,0,49
2020-10-19,Northland,0,0,0,0,26,2,0,28
2020-10-19,South Canterbury,0,0,0,0,15,2,0,17
2020-10-19,Southern,0,0,0,0,186,30,2,216
2020-10-19,Tairawhiti,0,0,0,0,3,1,0,4
2020-10-19,Taranaki,0,0,0,0,14,2,0,16
2020-10-19,Waikato,0,0,0,0,155,39,2,194
2020-10-19,Wairarapa,0,0,0,0,6,2,0,8
2020-10-19,Waitemata,0,0,0,0,223,71,4,294
2020-10-19,West Coast,0,0,0,0,4,1,1,5
2020-10-19,Whanganui,0,0,0,0,8,1,0,9
2020-10-18,Auckland,0,0,0,0,249,51,1,300
2020-10-18,Bay of Plenty,0,0,0,0,34,14,0,48
2020-10-18,Canterbury,0,0,0,0,132,65,12,197
2020-10-18,Capital and Coast,0,0,0,0,74,24,2,98
2020-10-18,Counties Manukau,1,0,0,1,267,24,1,291
2020-10-18,Hawke's Bay,0,0,0,0,38,6,0,44
2020-10-18,Hutt Valley,0,0,0,0,19,3,0,22
2020-10-18,Lakes,0,0,0,0,15,1,0,16
2020-10-18,Midcentral,0,0,0,0,27,5,0,32
2020-10-18,Nelson Marlborough,0,0,0,0,37,12,0,49
2020-10-18,Northland,0,0,0,0,26,2,0,28
2020-10-18,South Canterbury,0,0,0,0,15,2,0,17
2020-10-18,Southern,0,0,0,0,186,30,2,216
2020-10-18,Tairawhiti,0,0,0,0,3,1,0,4
2020-10-18,Taranaki,0,0,0,0,14,2,0,16
2020-10-18,Waikato,0,0,0,0,155,39,2,194
2020-10-18,Wairarapa,0,0,0,0,6,2,0,8
2020-10-18,Waitemata,0,0,0,0,223,71,4,294
2020-10-18,West Coast,0,0,0,0,4,1,1,5
2020-10-18,Whanganui,0,0,0,0,8,1,0,9
2020-10-17,Auckland,2,0,0,2,249,51,1,300
2020-10-17,Bay of Plenty,0,0,0,0,34,14,0,48
2020-10-17,Canterbury,0,0,0,0,132,65,12,197
2020-10-17,Capital and Coast,0,0,0,0,74,24,2,98
2020-10-17,Counties Manukau,1,0,0,1,266,24,1,290
2020-10-17,Hawke's Bay,0,0,0,0,38,6,0,44
2020-10-17,Hutt Valley,0,0,0,0,19,3,0,22
2020-10-17,Lakes,0,0,0,0,15,1,0,16
2020-10-17,Midcentral,0,0,0,0,27,5,0,32
2020-10-17,Nelson Marlborough,0,0,0,0,37,12,0,49
2020-10-17,Northland,0,0,0,0,26,2,0,28
2020-10-17,South Canterbury,0,0,0,0,15,2,0,17
2020-10-17,Southern,0,0,0,0,186,30,2,216
2020-10-17,Tairawhiti,0,0,0,0,3,1,0,4
2020-10-17,Taranaki,0,0,0,0,14,2,0,16
2020-10-17,Waikato,0,0,0,0,155,39,2,194
2020-10-17,Wairarapa,0,0,0,0,6,2,0,8
2020-10-17,Waitemata,1,0,0,1,223,71,4,294
2020-10-17,West Coast,0,0,0,0,4,1,1,5
2020-10-17,Whanganui,0,0,0,0,8,1,0,9
2020-10-16,Auckland,0,0,0,0,247,51,1,298
2020-10-16,Bay of Plenty,0,0,0,0,34,14,0,48
2020-10-16,Canterbury,1,0,0,1,132,65,12,197
2020-10-16,Capital and Coast,0,0,0,0,74,24,2,98
2020-10-16,Counties Manukau,0,0,0,0,265,24,1,289
2020-10-16,Hawke's Bay,0,0,0,0,38,6,0,44
2020-10-16,Hutt Valley,0,0,0,0,19,3,0,22
2020-10-16,Lakes,0,0,0,0,15,1,0,16
2020-10-16,Midcentral,0,0,0,0,27,5,0,32
2020-10-16,Nelson Marlborough,0,0,0,0,37,12,0,49
2020-10-16,Northland,0,0,0,0,26,2,0,28
2020-10-16,South Canterbury,0,0,0,0,15,2,0,17
2020-10-16,Southern,0,0,0,0,186,30,2,216
2020-10-16,Tairawhiti,0,0,0,0,3,1,0,4
2020-10-16,Taranaki,0,0,0,0,14,2,0,16
2020-10-16,Waikato,0,0,0,0,155,39,2,194
2020-10-16,Wairarapa,0,0,0,0,6,2,0,8
2020-10-16,Waitemata,0,0,0,0,222,71,4,293
2020-10-16,West Coast,0,0,0,0,4,1,1,5
2020-10-16,Whanganui,0,0,0,0,8,1,0,9
2020-10-15,Auckland,3,0,0,3,247,51,1,298
2020-10-15,Bay of Plenty,0,0,0,0,34,14,0,48
2020-10-15,Canterbury,1,0,0,1,131,65,12,196
2020-10-15,Capital and Coast,1,0,0,1,74,24,2,98
2020-10-15,Counties Manukau,0,0,0,0,265,24,1,289
2020-10-15,Hawke's Bay,0,0,0,0,38,6,0,44
2020-10-15,Hutt Valley,0,0,0,0,19,3,0,22
2020-10-15,Lakes,0,0,0,0,15,1,0,16
2020-10-15,Midcentral,0,0,0,0,27,5,0,32
2020-10-15,Nelson Marlborough,0,0,0,0,37,12,0,49
2020-10-15,Northland,0,0,0,0,26,2,0,28
2020-10-15,South Canterbury,0,0,0,0,15,2,0,17
2020-10-15,Southern,0,0,0,0,186,30,2,216
2020-10-15,Tairawhiti,0,0,0,0,3,1,0,4
2020-10-15,Taranaki,0,0,0,0,14,2,0,16
2020-10-15,Waikato,0,0,0,0,155,39,2,194
2020-10-15,Wairarapa,0,0,0,0,6,2,0,8
2020-10-15,Waitemata,0,0,0,0,222,71,4,293
2020-10-15,West Coast,0,0,0,0,4,1,1,5
2020-10-15,Whanganui,0,0,0,0,8,1,0,9
2020-10-14,Auckland,0,0,0,0,244,51,1,295
2020-10-14,Bay of Plenty,0,0,0,0,34,14,0,48
2020-10-14,Canterbury,1,0,0,1,130,65,12,195
2020-10-14,Capital and Coast,0,0,0,0,73,24,2,97
2020-10-14,Counties Manukau,0,0,0,0,265,24,1,289
2020-10-14,Hawke's Bay,0,0,0,0,38,6,0,44
2020-10-14,Hutt Valley,0,0,0,0,19,3,0,22
2020-10-14,Lakes,0,0,0,0,15,1,0,16
2020-10-14,Midcentral,0,0,0,0,27,5,0,32
2020-10-14,Nelson Marlborough,0,0,0,0,37,12,0,49
2020-10-14,Northland,0,0,0,0,26,2,0,28
2020-10-14,South Canterbury,0,0,0,0,15,2,0,17
2020-10-14,Southern,0,0,0,0,186,30,2,216
2020-10-14,Tairawhiti,0,0,0,0,3,1,0,4
2020-10-14,Taranaki,0,0,0,0,14,2,0,16
2020-10-14,Waikato,0,0,0,0,155,39,2,194
2020-10-14,Wairarapa,0,0,0,0,6,2,0,8
2020-10-14,Waitemata,0,0,0,0,222,71,4,293
2020-10-14,West Coast,0,0,0,0,4,1,1,5
2020-10-14,Whanganui,0,0,0,0,8,1,0,9
2020-10-13,Auckland,0,0,0,0,244,51,1,295
2020-10-13,Bay of Plenty,0,0,0,0,34,14,0,48
2020-10-13,Canterbury,0,0,0,0,129,65,12,194
2020-10-13,Capital and Coast,0,0,0,0,73,24,2,97
2020-10-13,Counties Manukau,2,0,0,2,265,24,1,289
2020-10-13,Hawke's Bay,0,0,0,0,38,6,0,44
2020-10-13,Hutt Valley,0,0,0,0,19,3,0,22
2020-10-13,Lakes,0,0,0,0,15,1,0,16
2020-10-13,Midcentral,0,0,0,0,27,5,0,32
2020-10-13,Nelson Marlborough,0,0,0,0,37,12,0,49
2020-10-13,Northland,0,0,0,0,26,2,0,28
2020-10-13,South Canterbury,0,0,0,0,15,2,0,17
2020-10-13,Southern,0,0,0,0,186,30,2,216
2020-10-13,Tairawhiti,0,0,0,0,3,1,0,4
2020-10-13,Taranaki,0,0,0,0,14,2,0,16
2020-10-13,Waikato,0,0,0,0,155,39,2,194
2020-10-13,Wairarapa,0,0,0,0,6,2,0,8
2020-10-13,Waitemata,0,0,0,0,222,71,4,293
2020-10-13,West Coast,0,0,0,0,4,1,1,5
2020-10-13,Whanganui,0,0,0,0,8,1,0,9
2020-10-12,Auckland,0,0,0,0,244,51,1,295
2020-10-12,Bay of Plenty,0,0,0,0,34,14,0,48
2020-10-12,Canterbury,1,0,0,1,129,65,12,194
2020-10-12,Capital and Coast,0,0,0,0,73,24,2,97
2020-10-12,Counties Manukau,0,0,0,0,263,24,1,287
2020-10-12,Hawke's Bay,0,0,0,0,38,6,0,44
2020-10-12,Hutt Valley,0,0,0,0,19,3,0,22
2020-10-12,Lakes,0,0,0,0,15,1,0,16
2020-10-12,Midcentral,0,0,0,0,27,5,0,32
2020-10-12,Nelson Marlborough,0,0,0,0,37,12,0,49
2020-10-12,Northland,0,0,0,0,26,2,0,28
2020-10-12,South Canterbury,0,0,0,0,15,2,0,17
2020-10-12,Southern,0,0,0,0,186,30,2,216
2020-10-12,Tairawhiti,0,0,0,0,3,1,0,4
2020-10-12,Taranaki,0,0,0,0,14,2,0,16
2020-10-12,Waikato,0,0,0,0,155,39,2,194
2020-10-12,Wairarapa,0,0,0,0,6,2,0,8
2020-10-12,Waitemata,0,0,0,0,222,71,4,293
2020-10-12,West Coast,0,0,0,0,4,1,1,5
2020-10-12,Whanganui,0,0,0,0,8,1,0,9
2020-10-11,Auckland,0,0,0,0,244,51,1,295
2020-10-11,Bay of Plenty,0,0,0,0,34,14,0,48
2020-10-11,Canterbury,0,0,0,0,128,65,12,193
2020-10-11,Capital and Coast,0,0,0,0,73,24,2,97
2020-10-11,Counties Manukau,2,0,0,2,263,24,1,287
2020-10-11,Hawke's Bay,0,0,0,0,38,6,0,44
2020-10-11,Hutt Valley,0,0,0,0,19,3,0,22
2020-10-11,Lakes,0,0,0,0,15,1,0,16
2020-10-11,Midcentral,0,0,0,0,27,5,0,32
2020-10-11,Nelson Marlborough,0,0,0,0,37,12,0,49
2020-10-11,Northland,0,0,0,0,26,2,0,28
2020-10-11,South Canterbury,0,0,0,0,15,2,0,17
2020-10-11,Southern,0,0,0,0,186,30,2,216
2020-10-11,Tairawhiti,0,0,0,0,3,1,0,4
2020-10-11,Taranaki,0,0,0,0,14,2,0,16
2020-10-11,Waikato,0,0,0,0,155,39,2,194
2020-10-11,Wairarapa,0,0,0,0,6,2,0,8
2020-10-11,Waitemata,0,0,0,0,222,71,4,293
2020-10-11,West Coast,0,0,0,0,4,1,1,5
2020-10-11,Whanganui,0,0,0,0,8,1,0,9
2020-10-10,Auckland,0,0,0,0,244,51,1,295
2020-10-10,Bay of Plenty,0,0,0,0,34,14,0,48
2020-10-10,Canterbury,0,0,0,0,128,65,12,193
2020-10-10,Capital and Coast,0,0,0,0,73,24,2,97
2020-10-10,Counties Manukau,0,0,0,0,261,24,1,285
2020-10-10,Hawke's Bay,0,0,0,0,38,6,0,44
2020-10-10,Hutt Valley,0,0,0,0,19,3,0,22
2020-10-10,Lakes,0,0,0,0,15,1,0,16
2020-10-10,Midcentral,0,0,0,0,27,5,0,32
2020-10-10,Nelson Marlborough,0,0,0,0,37,12,0,49
2020-10-10,Northland,0,0,0,0,26,2,0,28
2020-10-10,South Canterbury,0,0,0,0,15,2,0,17
2020-10-10,Southern,0,0,0,0,186,30,2,216
2020-10-10,Tairawhiti,0,0,0,0,3,1,0,4
2020-10-10,Taranaki,0,0,0,0,14,2,0,16
2020-10-10,Waikato,0,0,0,0,155,39,2,194
2020-10-10,Wairarapa,0,0,0,0,6,2,0,8
2020-10-10,Waitemata,0,0,0,0,222,71,4,293
2020-10-10,West Coast,0,0,0,0,4,1,1,5
2020-10-10,Whanganui,0,0,0,0,8,1,0,9
2020-10-09,Auckland,0,0,0,0,244,51,1,295
2020-10-09,Bay of Plenty,0,0,0,0,34,14,0,48
2020-10-09,Canterbury,0,0,0,0,128,65,12,193
2020-10-09,Capital and Coast,0,0,0,0,73,24,2,97
2020-10-09,Counties Manukau,4,0,0,4,261,24,1,285
2020-10-09,Hawke's Bay,0,0,0,0,38,6,0,44
2020-10-09,Hutt Valley,0,0,0,0,19,3,0,22
2020-10-09,Lakes,0,0,0,0,15,1,0,16
2020-10-09,Midcentral,0,0,0,0,27,5,0,32
2020-10-09,Nelson Marlborough,0,0,0,0,37,12,0,49
2020-10-09,Northland,0,0,0,0,26,2,0,28
2020-10-09,South Canterbury,0,0,0,0,15,2,0,17
2020-10-09,Southern,0,0,0,0,186,30,2,216
2020-10-09,Tairawhiti,0,0,0,0,3,1,0,4
2020-10-09,Taranaki,0,0,0,0,14,2,0,16
2020-10-09,Waikato,0,0,0,0,155,39,2,194
2020-10-09,Wairarapa,0,0,0,0,6,2,0,8
2020-10-09,Waitemata,0,0,0,0,222,71,4,293
2020-10-09,West Coast,0,0,0,0,4,1,1,5
2020-10-09,Whanganui,0,0,0,0,8,1,0,9
2020-10-08,Auckland,2,0,0,2,244,51,1,295
2020-10-08,Bay of Plenty,0,0,0,0,34,14,0,48
2020-10-08,Canterbury,0,0,0,0,128,65,12,193
2020-10-08,Capital and Coast,0,0,0,0,73,24,2,97
2020-10-08,Counties Manukau,1,0,0,1,257,24,1,281
2020-10-08,Hawke's Bay,0,0,0,0,38,6,0,44
2020-10-08,Hutt Valley,0,0,0,0,19,3,0,22
2020-10-08,Lakes,0,0,0,0,15,1,0,16
2020-10-08,Midcentral,0,0,0,0,27,5,0,32
2020-10-08,Nelson Marlborough,0,0,0,0,37,12,0,49
2020-10-08,Northland,0,0,0,0,26,2,0,28
2020-10-08,South Canterbury,0,0,0,0,15,2,0,17
2020-10-08,Southern,0,0,0,0,186,30,2,216
2020-10-08,Tairawhiti,0,0,0,0,3,1,0,4
2020-10-08,Taranaki,0,0,0,0,14,2,0,16
2020-10-08,Waikato,0,0,0,0,155,39,2,194
2020-10-08,Wairarapa,0,0,0,0,6,2,0,8
2020-10-08,Waitemata,0,0,0,0,222,71,4,293
2020-10-08,West Coast,0,0,0,0,4,1,1,5
2020-10-08,Whanganui,0,0,0,0,8,1,0,9
2020-10-07,Auckland,1,0,0,1,242,51,1,293
2020-10-07,Bay of Plenty,0,0,0,0,34,14,0,48
2020-10-07,Canterbury,1,0,0,1,128,65,12,193
2020-10-07,Capital and Coast,0,0,0,0,73,24,2,97
2020-10-07,Counties Manukau,1,0,0,1,256,24,1,280
2020-10-07,Hawke's Bay,0,0,0,0,38,6,0,44
2020-10-07,Hutt Valley,0,0,0,0,19,3,0,22
2020-10-07,Lakes,0,0,0,0,15,1,0,16
2020-10-07,Midcentral,0,0,0,0,27,5,0,32
2020-10-07,Nelson Marlborough,0,0,0,0,37,12,0,49
2020-10-07,Northland,0,0,0,0,26,2,0,28
2020-10-07,South Canterbury,0,0,0,0,15,2,0,17
2020-10-07,Southern,0,0,0,0,186,30,2,216
2020-10-07,Tairawhiti,0,0,0,0,3,1,0,4
2020-10-07,Taranaki,0,0,0,0,14,2,0,16
2020-10-07,Waikato,0,0,0,0,155,39,2,194
2020-10-07,Wairarapa,0,0,0,0,6,2,0,8
2020-10-07,Waitemata,0,0,0,0,222,71,4,293
2020-10-07,West Coast,0,0,0,0,4,1,1,5
2020-10-07,Whanganui,0,0,0,0,8,1,0,9
2020-10-06,Auckland,0,0,0,0,241,51,1,292
2020-10-06,Bay of Plenty,0,0,0,0,34,14,0,48
2020-10-06,Canterbury,0,0,0,0,127,65,12,192
2020-10-06,Capital and Coast,0,0,0,0,73,24,2,97
2020-10-06,Counties Manukau,2,0,0,2,255,24,1,279
2020-10-06,Hawke's Bay,0,0,0,0,38,6,0,44
2020-10-06,Hutt Valley,0,0,0,0,19,3,0,22
2020-10-06,Lakes,0,0,0,0,15,1,0,16
2020-10-06,Midcentral,0,0,0,0,27,5,0,32
2020-10-06,Nelson Marlborough,0,0,0,0,37,12,0,49
2020-10-06,Northland,0,0,0,0,26,2,0,28
2020-10-06,South Canterbury,0,0,0,0,15,2,0,17
2020-10-06,Southern,0,0,0,0,186,30,2,216
2020-10-06,Tairawhiti,0,0,0,0,3,1,0,4
2020-10-06,Taranaki,0,0,0,0,14,2,0,16
2020-10-06,Waikato,0,0,0,0,155,39,2,194
2020-10-06,Wairarapa,0,0,0,0,6,2,0,8
2020-10-06,Waitemata,0,0,0,0,222,71,4,293
2020-10-06,West Coast,0,0,0,0,4,1,1,5
2020-10-06,Whanganui,0,0,0,0,8,1,0,9
2020-10-05,Auckland,1,0,0,1,241,51,1,292
2020-10-05,Bay of Plenty,0,0,0,0,34,14,0,48
2020-10-05,Canterbury,0,0,0,0,127,65,12,192
2020-10-05,Capital and Coast,0,0,0,0,73,24,2,97
2020-10-05,Counties Manukau,2,0,0,2,253,24,1,277
2020-10-05,Hawke's Bay,0,0,0,0,38,6,0,44
2020-10-05,Hutt Valley,0,0,0,0,19,3,0,22
2020-10-05,Lakes,0,0,0,0,15,1,0,16
2020-10-05,Midcentral,0,0,0,0,27,5,0,32
2020-10-05,Nelson Marlborough,0,0,0,0,37,12,0,49
2020-10-05,Northland,0,0,0,0,26,2,0,28
2020-10-05,South Canterbury,0,0,0,0,15,2,0,17
2020-10-05,Southern,0,0,0,0,186,30,2,216
2020-10-05,Tairawhiti,0,0,0,0,3,1,0,4
2020-10-05,Taranaki,0,0,0,0,14,2,0,16
2020-10-05,Waikato,0,0,0,0,155,39,2,194
2020-10-05,Wairarapa,0,0,0,0,6,2,0,8
2020-10-05,Waitemata,0,0,0,0,222,71,4,293
2020-10-05,West Coast,0,0,0,0,4,1,1,5
2020-10-05,Whanganui,0,0,0,0,8,1,0,9
2020-10-04,Auckland,1,0,0,1,240,51,1,291
2020-10-04,Bay of Plenty,0,0,0,0,34,14,0,48
2020-10-04,Canterbury,0,0,0,0,127,65,12,192
2020-10-04,Capital and Coast,0,0,0,0,73,24,2,97
2020-10-04,Counties Manukau,1,0,0,1,251,24,1,275
2020-10-04,Hawke's Bay,0,0,0,0,38,6,0,44
2020-10-04,Hutt Valley,0,0,0,0,19,3,0,22
2020-10-04,Lakes,0,0,0,0,15,1,0,16
2020-10-04,Midcentral,0,0,0,0,27,5,0,32
2020-10-04,Nelson Marlborough,0,0,0,0,37,12,0,49
2020-10-04,Northland,0,0,0,0,26,2,0,28
2020-10-04,South Canterbury,0,0,0,0,15,2,0,17
2020-10-04,Southern,0,0,0,0,186,30,2,216
2020-10-04,Tairawhiti,0,0,0,0,3,1,0,4
2020-10-04,Taranaki,0,0,0,0,14,2,0,16
2020-10-04,Waikato,0,0,0,0,155,39,2,194
2020-10-04,Wairarapa,0,0,0,0,6,2,0,8
2020-10-04,Waitemata,0,0,0,0,222,71,4,293
2020-10-04,West Coast,0,0,0,0,4,1,1,5
2020-10-04,Whanganui,0,0,0,0,8,1,0,9
2020-10-03,Auckland,1,0,0,1,239,51,1,290
2020-10-03,Bay of Plenty,0,0,0,0,34,14,0,48
2020-10-03,Canterbury,0,0,0,0,127,65,12,192
2020-10-03,Capital and Coast,0,0,0,0,73,24,2,97
2020-10-03,Counties Manukau,3,0,0,3,250,24,1,274
2020-10-03,Hawke's Bay,0,0,0,0,38,6,0,44
2020-10-03,Hutt Valley,0,0,0,0,19,3,0,22
2020-10-03,Lakes,0,0,0,0,15,1,0,16
2020-10-03,Midcentral,0,0,0,0,27,5,0,32
2020-10-03,Nelson Marlborough,0,0,0,0,37,12,0,49
2020-10-03,Northland,0,0,0,0,26,2,0,28
2020-10-03,South Canterbury,0,0,0,0,15,2,0,17
2020-10-03,Southern,0,0,0,0,186,30,2,216
2020-10-03,Tairawhiti,0,0,0,0,3,1,0,4
2020-10-03,Taranaki,0,0,0,0,14,2,0,16
2020-10-03,Waikato,0,0,0,0,155,39,2,194
2020-10-03,Wairarapa,0,0,0,0,6,2,0,8
2020-10-03,Waitemata,0,0,0,0,222,71,4,293
2020-10-03,West Coast,0,0,0,0,4,1,1,5
2020-10-03,Whanganui,0,0,0,0,8,1,0,9
2020-10-02,Auckland,0,0,0,0,238,51,1,289
2020-10-02,Bay of Plenty,0,0,0,0,34,14,0,48
2020-10-02,Canterbury,1,0,0,1,127,65,12,192
2020-10-02,Capital and Coast,0,0,0,0,73,24,2,97
2020-10-02,Counties Manukau,1,0,0,1,247,24,1,271
2020-10-02,Hawke's Bay,0,0,0,0,38,6,0,44
2020-10-02,Hutt Valley,0,0,0,0,19,3,0,22
2020-10-02,Lakes,0,0,0,0,15,1,0,16
2020-10-02,Midcentral,0,0,0,0,27,5,0,32
2020-10-02,Nelson Marlborough,0,0,0,0,37,12,0,49
2020-10-02,Northland,0,0,0,0,26,2,0,28
2020-10-02,South Canterbury,0,0,0,0,15,2,0,17
2020-10-02,Southern,0,0,0,0,186,30,2,216
2020-10-02,Tairawhiti,0,0,0,0,3,1,0,4
2020-10-02,Taranaki,0,0,0,0,14,2,0,16
2020-10-02,Waikato,0,0,0,0,155,39,2,194
2020-10-02,Wairarapa,0,0,0,0,6,2,0,8
2020-10-02,Waitemata,0,0,0,0,222,71,4,293
2020-10-02,West Coast,0,0,0,0,4,1,1,5
2020-10-02,Whanganui,0,0,0,0,8,1,0,9
2020-10-01,Auckland,6,0,0,6,238,51,1,289
2020-10-01,Bay of Plenty,0,0,0,0,34,14,0,48
2020-10-01,Canterbury,0,0,0,0,126,65,12,191
2020-10-01,Capital and Coast,0,0,0,0,73,24,2,97
2020-10-01,Counties Manukau,0,0,0,0,246,24,1,270
2020-10-01,Hawke's Bay,0,0,0,0,38,6,0,44
2020-10-01,Hutt Valley,0,0,0,0,19,3,0,22
2020-10-01,Lakes,0,0,0,0,15,1,0,16
2020-10-01,Midcentral,0,0,0,0,27,5,0,32
2020-10-01,Nelson Marlborough,0,0,0,0,37,12,0,49
2020-10-01,Northland,0,0,0,0,26,2,0,28
2020-10-01,South Canterbury,0,0,0,0,15,2,0,17
2020-10-01,Southern,0,0,0,0,186,30,2,216
2020-10-01,Tairawhiti,0,0,0,0,3,1,0,4
2020-10-01,Taranaki,0,0,0,0,14,2,0,16
2020-10-01,Waikato,0,0,0,0,155,39,2,194
2020-10-01,Wairarapa,0,0,0,0,6,2,0,8
2020-10-01,Waitemata,0,0,0,0,222,71,4,293
2020-10-01,West Coast,0,0,0,0,4,1,1,5
2020-10-01,Whanganui,0,0,0,0,8,1,0,9
2020-09-30,Auckland,4,0,0,4,232,51,1,283
2020-09-30,Bay of Plenty,0,0,0,0,34,14,0,48
2020-09-30,Canterbury,1,0,0,1,126,65,12,191
2020-09-30,Capital and Coast,0,0,0,0,73,24,2,97
2020-09-30,Counties Manukau,1,0,0,1,246,24,1,270
2020-09-30,Hawke's Bay,0,0,0,0,38,6,0,44
2020-09-30,Hutt Valley,0,0,0,0,19,3,0,22
2020-09-30,Lakes,0,0,0,0,15,1,0,16
2020-09-30,Midcentral,0,0,0,0,27,5,0,32
2020-09-30,Nelson Marlborough,0,0,0,0,37,12,0,49
2020-09-30,Northland,0,0,0,0,26,2,0,28
2020-09-30,South Canterbury,0,0,0,0,15,2,0,17
2020-09-30,Southern,0,0,0,0,186,30,2,216
2020-09-30,Tairawhiti,0,0,0,0,3,1,0,4
2020-09-30,Taranaki,0,0,0,0,14,2,0,16
2020-09-30,Waikato,0,0,0,0,155,39,2,194
2020-09-30,Wairarapa,0,0,0,0,6,2,0,8
2020-09-30,Waitemata,0,0,0,0,222,71,4,293
2020-09-30,West Coast,0,0,0,0,4,1,1,5
2020-09-30,Whanganui,0,0,0,0,8,1,0,9
2020-09-29,Auckland,0,0,0,0,228,51,1,279
2020-09-29,Bay of Plenty,0,0,0,0,34,14,0,48
2020-09-29,Canterbury,0,0,0,0,125,65,12,190
2020-09-29,Capital and Coast,0,0,0,0,73,24,2,97
2020-09-29,Counties Manukau,0,0,0,0,245,24,1,269
2020-09-29,Hawke's Bay,0,0,0,0,38,6,0,44
2020-09-29,Hutt Valley,0,0,0,0,19,3,0,22
2020-09-29,Lakes,0,0,0,0,15,1,0,16
2020-09-29,Midcentral,0,0,0,0,27,5,0,32
2020-09-29,Nelson Marlborough,0,0,0,0,37,12,0,49
2020-09-29,Northland,0,0,0,0,26,2,0,28
2020-09-29,South Canterbury,0,0,0,0,15,2,0,17
2020-09-29,Southern,0,0,0,0,186,30,2,216
2020-09-29,Tairawhiti,0,0,0,0,3,1,0,4
2020-09-29,Taranaki,0,0,0,0,14,2,0,16
2020-09-29,Waikato,0,0,0,0,155,39,2,194
2020-09-29,Wairarapa,0,0,0,0,6,2,0,8
2020-09-29,Waitemata,0,0,0,0,222,71,4,293
2020-09-29,West Coast,0,0,0,0,4,1,1,5
2020-09-29,Whanganui,0,0,0,0,8,1,0,9
2020-09-28,Auckland,1,0,0,1,228,51,1,279
2020-09-28,Bay of Plenty,0,0,0,0,34,14,0,48
2020-09-28,Canterbury,0,0,0,0,125,65,12,190
2020-09-28,Capital and Coast,0,0,0,0,73,24,2,97
2020-09-28,Counties Manukau,0,0,0,0,245,24,1,269
2020-09-28,Hawke's Bay,0,0,0,0,38,6,0,44
2020-09-28,Hutt Valley,0,0,0,0,19,3,0,22
2020-09-28,Lakes,0,0,0,0,15,1,0,16
2020-09-28,Midcentral,0,0,0,0,27,5,0,32
2020-09-28,Nelson Marlborough,0,0,0,0,37,12,0,49
2020-09-28,Northland,0,0,0,0,26,2,0,28
2020-09-28,South Canterbury,0,0,0,0,15,2,0,17
2020-09-28,Southern,0,0,0,0,186,30,2,216
2020-09-28,Tairawhiti,0,0,0,0,3,1,0,4
2020-09-28,Taranaki,0,0,0,0,14,2,0,16
2020-09-28,Waikato,0,0,0,0,155,39,2,194
2020-09-28,Wairarapa,0,0,0,0,6,2,0,8
2020-09-28,Waitemata,0,0,0,0,222,71,4,293
2020-09-28,West Coast,0,0,0,0,4,1,1,5
2020-09-28,Whanganui,0,0,0,0,8,1,0,9
2020-09-27,Auckland,0,0,0,0,227,51,1,278
2020-09-27,Bay of Plenty,0,0,0,0,34,14,0,48
2020-09-27,Canterbury,0,0,0,0,125,65,12,190
2020-09-27,Capital and Coast,0,0,0,0,73,24,2,97
2020-09-27,Counties Manukau,2,0,0,2,245,24,1,269
2020-09-27,Hawke's Bay,0,0,0,0,38,6,0,44
2020-09-27,Hutt Valley,0,0,0,0,19,3,0,22
2020-09-27,Lakes,0,0,0,0,15,1,0,16
2020-09-27,Midcentral,0,0,0,0,27,5,0,32
2020-09-27,Nelson Marlborough,0,0,0,0,37,12,0,49
2020-09-27,Northland,0,0,0,0,26,2,0,28
2020-09-27,South Canterbury,0,0,0,0,15,2,0,17
2020-09-27,Southern,0,0,0,0,186,30,2,216
2020-09-27,Tairawhiti,0,0,0,0,3,1,0,4
2020-09-27,Taranaki,0,0,0,0,14,2,0,16
2020-09-27,Waikato,0,0,0,0,155,39,2,194
2020-09-27,Wairarapa,0,0,0,0,6,2,0,8
2020-09-27,Waitemata,0,0,0,0,222,71,4,293
2020-09-27,West Coast,0,0,0,0,4,1,1,5
2020-09-27,Whanganui,0,0,0,0,8,1,0,9
2020-09-26,Auckland,2,0,0,2,227,51,1,278
2020-09-26,Bay of Plenty,0,0,0,0,34,14,0,48
2020-09-26,Canterbury,0,0,0,0,125,65,12,190
2020-09-26,Capital and Coast,0,0,0,0,73,24,2,97
2020-09-26,Counties Manukau,0,0,0,0,243,24,1,267
2020-09-26,Hawke's Bay,0,0,0,0,38,6,0,44
2020-09-26,Hutt Valley,0,0,0,0,19,3,0,22
2020-09-26,Lakes,0,0,0,0,15,1,0,16
2020-09-26,Midcentral,0,0,0,0,27,5,0,32
2020-09-26,Nelson Marlborough,0,0,0,0,37,12,0,49
2020-09-26,Northland,0,0,0,0,26,2,0,28
2020-09-26,South Canterbury,0,0,0,0,15,2,0,17
2020-09-26,Southern,0,0,0,0,186,30,2,216
2020-09-26,Tairawhiti,0,0,0,0,3,1,0,4
2020-09-26,Taranaki,0,0,0,0,14,2,0,16
2020-09-26,Waikato,0,0,0,0,155,39,2,194
2020-09-26,Wairarapa,0,0,0,0,6,2,0,8
2020-09-26,Waitemata,0,0,0,0,222,71,4,293
2020-09-26,West Coast,0,0,0,0,4,1,1,5
2020-09-26,Whanganui,0,0,0,0,8,1,0,9
2020-09-25,Auckland,1,0,0,1,225,51,1,276
2020-09-25,Bay of Plenty,0,0,0,0,34,14,0,48
2020-09-25,Canterbury,0,0,0,0,125,65,12,190
2020-09-25,Capital and Coast,0,0,0,0,73,24,2,97
2020-09-25,Counties Manukau,0,0,0,0,243,24,1,267
2020-09-25,Hawke's Bay,0,0,0,0,38,6,0,44
2020-09-25,Hutt Valley,0,0,0,0,19,3,0,22
2020-09-25,Lakes,0,0,0,0,15,1,0,16
2020-09-25,Midcentral,0,0,0,0,27,5,0,32
2020-09-25,Nelson Marlborough,0,0,0,0,37,12,0,49
2020-09-25,Northland,0,0,0,0,26,2,0,28
2020-09-25,South Canterbury,0,0,0,0,15,2,0,17
2020-09-25,Southern,0,0,0,0,186,30,2,216
2020-09-25,Tairawhiti,0,0,0,0,3,1,0,4
2020-09-25,Taranaki,0,0,0,0,14,2,0,16
2020-09-25,Waikato,0,0,0,0,155,39,2,194
2020-09-25,Wairarapa,0,0,0,0,6,2,0,8
2020-09-25,Waitemata,0,0,0,0,222,71,4,293
2020-09-25,West Coast,0,0,0,0,4,1,1,5
2020-09-25,Whanganui,0,0,0,0,8,1,0,9
2020-09-24,Auckland,1,0,0,1,224,51,1,275
2020-09-24,Bay of Plenty,0,0,0,0,34,14,0,48
2020-09-24,Canterbury,0,0,0,0,125,65,12,190
2020-09-24,Capital and Coast,0,0,0,0,73,24,2,97
2020-09-24,Counties Manukau,0,0,0,0,243,24,1,267
2020-09-24,Hawke's Bay,0,0,0,0,38,6,0,44
2020-09-24,Hutt Valley,0,0,0,0,19,3,0,22
2020-09-24,Lakes,0,0,0,0,15,1,0,16
2020-09-24,Midcentral,0,0,0,0,27,5,0,32
2020-09-24,Nelson Marlborough,0,0,0,0,37,12,0,49
2020-09-24,Northland,0,0,0,0,26,2,0,28
2020-09-24,South Canterbury,0,0,0,0,15,2,0,17
2020-09-24,Southern,0,0,0,0,186,30,2,216
2020-09-24,Tairawhiti,0,0,0,0,3,1,0,4
2020-09-24,Taranaki,0,0,0,0,14,2,0,16
2020-09-24,Waikato,0,0,0,0,155,39,2,194
2020-09-24,Wairarapa,0,0,0,0,6,2,0,8
2020-09-24,Waitemata,1,0,0,1,222,71,4,293
2020-09-24,West Coast,0,0,0,0,4,1,1,5
2020-09-24,Whanganui,0,0,0,0,8,1,0,9
2020-09-23,Auckland,1,0,0,1,223,51,1,274
2020-09-23,Bay of Plenty,0,0,0,0,34,14,0,48
2020-09-23,Canterbury,0,0,0,0,125,65,12,190
2020-09-23,Capital and Coast,0,0,0,0,73,24,2,97
2020-09-23,Counties Manukau,2,0,0,2,243,24,1,267
2020-09-23,Hawke's Bay,0,0,0,0,38,6,0,44
2020-09-23,Hutt Valley,0,0,0,0,19,3,0,22
2020-09-23,Lakes,0,0,0,0,15,1,0,16
2020-09-23,Midcentral,0,0,0,0,27,5,0,32
2020-09-23,Nelson Marlborough,0,0,0,0,37,12,0,49
2020-09-23,Northland,0,0,0,0,26,2,0,28
2020-09-23,South Canterbury,0,0,0,0,15,2,0,17
2020-09-23,Southern,0,0,0,0,186,30,2,216
2020-09-23,Tairawhiti,0,0,0,0,3,1,0,4
2020-09-23,Taranaki,0,0,0,0,14,2,0,16
2020-09-23,Waikato,0,0,0,0,155,39,2,194
2020-09-23,Wairarapa,0,0,0,0,6,2,0,8
2020-09-23,Waitemata,0,0,0,0,221,71,4,292
2020-09-23,West Coast,0,0,0,0,4,1,1,5
2020-09-23,Whanganui,0,0,0,0,8,1,0,9
2020-09-22,Auckland,3,0,0,3,222,51,1,273
2020-09-22,Bay of Plenty,0,0,0,0,34,14,0,48
2020-09-22,Canterbury,0,0,0,0,125,65,12,190
2020-09-22,Capital and Coast,0,0,0,0,73,24,2,97
2020-09-22,Counties Manukau,0,0,0,0,241,24,1,265
2020-09-22,Hawke's Bay,0,0,0,0,38,6,0,44
2020-09-22,Hutt Valley,0,0,0,0,19,3,0,22
2020-09-22,Lakes,0,0,0,0,15,1,0,16
2020-09-22,Midcentral,0,0,0,0,27,5,0,32
2020-09-22,Nelson Marlborough,0,0,0,0,37,12,0,49
2020-09-22,Northland,0,0,0,0,26,2,0,28
2020-09-22,South Canterbury,0,0,0,0,15,2,0,17
2020-09-22,Southern,0,0,0,0,186,30,2,216
2020-09-22,Tairawhiti,0,0,0,0,3,1,0,4
2020-09-22,Taranaki,0,0,0,0,14,2,0,16
2020-09-22,Waikato,0,0,0,0,155,39,2,194
2020-09-22,Wairarapa,0,0,0,0,6,2,0,8
2020-09-22,Waitemata,0,0,0,0,221,71,4,292
2020-09-22,West Coast,0,0,0,0,4,1,1,5
2020-09-22,Whanganui,0,0,0,0,8,1,0,9
2020-09-21,Auckland,0,0,0,0,219,51,1,270
2020-09-21,Bay of Plenty,0,0,0,0,34,14,0,48
2020-09-21,Canterbury,0,0,0,0,125,65,12,190
2020-09-21,Capital and Coast,0,0,0,0,73,24,2,97
2020-09-21,Counties Manukau,1,0,0,1,241,24,1,265
2020-09-21,Hawke's Bay,0,0,0,0,38,6,0,44
2020-09-21,Hutt Valley,0,0,0,0,19,3,0,22
2020-09-21,Lakes,0,0,0,0,15,1,0,16
2020-09-21,Midcentral,0,0,0,0,27,5,0,32
2020-09-21,Nelson Marlborough,0,0,0,0,37,12,0,49
2020-09-21,Northland,0,0,0,0,26,2,0,28
2020-09-21,South Canterbury,0,0,0,0,15,2,0,17
2020-09-21,Southern,0,0,0,0,186,30,2,216
2020-09-21,Tairawhiti,0,0,0,0,3,1,0,4
2020-09-21,Taranaki,0,0,0,0,14,2,0,16
2020-09-21,Waikato,0,0,0,0,155,39,2,194
2020-09-21,Wairarapa,0,0,0,0,6,2,0,8
2020-09-21,Waitemata,0,0,0,0,221,71,4,292
2020-09-21,West Coast,0,0,0,0,4,1,1,5
2020-09-21,Whanganui,0,0,0,0,8,1,0,9
2020-09-20,Auckland,0,0,0,0,219,51,1,270
2020-09-20,Bay of Plenty,0,0,0,0,34,14,0,48
2020-09-20,Canterbury,0,0,0,0,125,65,12,190
2020-09-20,Capital and Coast,0,0,0,0,73,24,2,97
2020-09-20,Counties Manukau,0,0,0,0,240,24,1,264
2020-09-20,Hawke's Bay,0,0,0,0,38,6,0,44
2020-09-20,Hutt Valley,0,0,0,0,19,3,0,22
2020-09-20,Lakes,0,0,0,0,15,1,0,16
2020-09-20,Midcentral,0,0,0,0,27,5,0,32
2020-09-20,Nelson Marlborough,0,0,0,0,37,12,0,49
2020-09-20,Northland,0,0,0,0,26,2,0,28
2020-09-20,South Canterbury,0,0,0,0,15,2,0,17
2020-09-20,Southern,0,0,0,0,186,30,2,216
2020-09-20,Tairawhiti,0,0,0,0,3,1,0,4
2020-09-20,Taranaki,0,0,0,0,14,2,0,16
2020-09-20,Waikato,0,0,0,0,155,39,2,194
2020-09-20,Wairarapa,0,0,0,0,6,2,0,8
2020-09-20,Waitemata,0,0,0,0,221,71,4,292
2020-09-20,West Coast,0,0,0,0,4,1,1,5
2020-09-20,Whanganui,0,0,0,0,8,1,0,9
2020-09-19,Auckland,1,0,0,1,219,51,1,270
2020-09-19,Bay of Plenty,0,0,0,0,34,14,0,48
2020-09-19,Canterbury,0,0,0,0,125,65,12,190
2020-09-19,Capital and Coast,0,0,0,0,73,24,2,97
2020-09-19,Counties Manukau,2,0,0,2,240,24,1,264
2020-09-19,Hawke's Bay,0,0,0,0,38,6,0,44
2020-09-19,Hutt Valley,0,0,0,0,19,3,0,22
2020-09-19,Lakes,0,0,0,0,15,1,0,16
2020-09-19,Midcentral,0,0,0,0,27,5,0,32
2020-09-19,Nelson Marlborough,0,0,0,0,37,12,0,49
2020-09-19,Northland,0,0,0,0,26,2,0,28
2020-09-19,South Canterbury,0,0,0,0,15,2,0,17
2020-09-19,Southern,0,0,0,0,186,30,2,216
2020-09-19,Tairawhiti,0,0,0,0,3,1,0,4
2020-09-19,Taranaki,0,0,0,0,14,2,0,16
2020-09-19,Waikato,0,0,0,0,155,39,2,194
2020-09-19,Wairarapa,0,0,0,0,6,2,0,8
2020-09-19,Waitemata,0,0,0,0,221,71,4,292
2020-09-19,West Coast,0,0,0,0,4,1,1,5
2020-09-19,Whanganui,0,0,0,0,8,1,0,9
2020-09-18,Auckland,2,0,0,2,218,51,1,269
2020-09-18,Bay of Plenty,0,0,0,0,34,14,0,48
2020-09-18,Canterbury,0,0,0,0,125,65,12,190
2020-09-18,Capital and Coast,0,0,0,0,73,24,2,97
2020-09-18,Counties Manukau,1,0,0,1,238,24,1,262
2020-09-18,Hawke's Bay,0,0,0,0,38,6,0,44
2020-09-18,Hutt Valley,0,0,0,0,19,3,0,22
2020-09-18,Lakes,0,0,0,0,15,1,0,16
2020-09-18,Midcentral,0,0,0,0,27,5,0,32
2020-09-18,Nelson Marlborough,0,0,0,0,37,12,0,49
2020-09-18,Northland,0,0,0,0,26,2,0,28
2020-09-18,South Canterbury,0,0,0,0,15,2,0,17
2020-09-18,Southern,0,0,0,0,186,30,2,216
2020-09-18,Tairawhiti,0,0,0,0,3,1,0,4
2020-09-18,Taranaki,0,0,0,0,14,2,0,16
2020-09-18,Waikato,0,0,0,0,155,39,2,194
2020-09-18,Wairarapa,0,0,0,0,6,2,0,8
2020-09-18,Waitemata,0,0,0,0,221,71,4,292
2020-09-18,West Coast,0,0,0,0,4,1,1,5
2020-09-18,Whanganui,0,0,0,0,8,1,0,9
2020-09-17,Auckland,0,0,0,0,216,51,1,267
2020-09-17,Bay of Plenty,0,0,0,0,34,14,0,48
2020-09-17,Canterbury,0,0,0,0,125,65,12,190
2020-09-17,Capital and Coast,0,0,0,0,73,24,2,97
2020-09-17,Counties Manukau,0,0,0,0,237,24,1,261
2020-09-17,Hawke's Bay,0,0,0,0,38,6,0,44
2020-09-17,Hutt Valley,0,0,0,0,19,3,0,22
2020-09-17,Lakes,0,0,0,0,15,1,0,16
2020-09-17,Midcentral,0,0,0,0,27,5,0,32
2020-09-17,Nelson Marlborough,0,0,0,0,37,12,0,49
2020-09-17,Northland,0,0,0,0,26,2,0,28
2020-09-17,South Canterbury,0,0,0,0,15,2,0,17
2020-09-17,Southern,0,0,0,0,186,30,2,216
2020-09-17,Tairawhiti,0,0,0,0,3,1,0,4
2020-09-17,Taranaki,0,0,0,0,14,2,0,16
2020-09-17,Waikato,0,0,0,0,155,39,2,194
2020-09-17,Wairarapa,0,0,0,0,6,2,0,8
2020-09-17,Waitemata,0,0,0,0,221,71,4,292
2020-09-17,West Coast,0,0,0,0,4,1,1,5
2020-09-17,Whanganui,0,0,0,0,8,1,0,9
2020-09-16,Auckland,4,0,0,4,216,51,1,267
2020-09-16,Bay of Plenty,0,0,0,0,34,14,0,48
2020-09-16,Canterbury,1,0,0,1,125,65,12,190
2020-09-16,Capital and Coast,1,0,0,1,73,24,2,97
2020-09-16,Counties Manukau,1,0,0,1,237,24,1,261
2020-09-16,Hawke's Bay,0,0,0,0,38,6,0,44
2020-09-16,Hutt Valley,0,0,0,0,19,3,0,22
2020-09-16,Lakes,0,0,0,0,15,1,0,16
2020-09-16,Midcentral,0,0,0,0,27,5,0,32
2020-09-16,Nelson Marlborough,0,0,0,0,37,12,0,49
2020-09-16,Northland,0,0,0,0,26,2,0,28
2020-09-16,South Canterbury,0,0,0,0,15,2,0,17
2020-09-16,Southern,0,0,0,0,186,30,2,216
2020-09-16,Tairawhiti,0,0,0,0,3,1,0,4
2020-09-16,Taranaki,0,0,0,0,14,2,0,16
2020-09-16,Waikato,0,5,0,5,155,39,2,194
2020-09-16,Wairarapa,0,0,0,0,6,2,0,8
2020-09-16,Waitemata,0,0,0,0,221,71,4,292
2020-09-16,West Coast,0,0,0,0,4,1,1,5
2020-09-16,Whanganui,0,0,0,0,8,1,0,9
2020-09-15,Auckland,0,0,0,0,212,51,1,263
2020-09-15,Bay of Plenty,0,0,0,0,34,14,0,48
2020-09-15,Canterbury,0,0,0,0,124,65,12,189
2020-09-15,Capital and Coast,0,0,0,0,72,24,2,96
2020-09-15,Counties Manukau,0,0,0,0,236,24,1,260
2020-09-15,Hawke's Bay,0,0,0,0,38,6,0,44
2020-09-15,Hutt Valley,0,0,0,0,19,3,0,22
2020-09-15,Lakes,0,0,0,0,15,1,0,16
2020-09-15,Midcentral,0,0,0,0,27,5,0,32
2020-09-15,Nelson Marlborough,0,0,0,0,37,12,0,49
2020-09-15,Northland,0,0,0,0,26,2,0,28
2020-09-15,South Canterbury,0,0,0,0,15,2,0,17
2020-09-15,Southern,0,0,0,0,186,30,2,216
2020-09-15,Tairawhiti,0,0,0,0,3,1,0,4
2020-09-15,Taranaki,0,0,0,0,14,2,0,16
2020-09-15,Waikato,0,0,1,0,155,34,2,189
2020-09-15,Wairarapa,0,0,0,0,6,2,0,8
2020-09-15,Waitemata,0,0,0,0,221,71,4,292
2020-09-15,West Coast,0,0,0,0,4,1,1,5
2020-09-15,Whanganui,0,0,0,0,8,1,0,9
2020-09-14,Auckland,0,0,0,0,212,51,1,263
2020-09-14,Bay of Plenty,0,0,0,0,34,14,0,48
2020-09-14,Canterbury,0,0,0,0,124,65,12,189
2020-09-14,Capital and Coast,0,0,0,0,72,24,2,96
2020-09-14,Counties Manukau,4,0,0,4,236,24,1,260
2020-09-14,Hawke's Bay,0,0,0,0,38,6,0,44
2020-09-14,Hutt Valley,0,0,0,0,19,3,0,22
2020-09-14,Lakes,0,0,0,0,15,1,0,16
2020-09-14,Midcentral,0,0,0,0,27,5,0,32
2020-09-14,Nelson Marlborough,0,0,0,0,37,12,0,49
2020-09-14,Northland,0,0,0,0,26,2,0,28
2020-09-14,South Canterbury,0,0,0,0,15,2,0,17
2020-09-14,Southern,0,0,0,0,186,30,2,216
2020-09-14,Tairawhiti,0,0,0,0,3,1,0,4
2020-09-14,Taranaki,0,0,0,0,14,2,0,16
2020-09-14,Waikato,1,0,0,1,155,34,1,189
2020-09-14,Wairarapa,0,0,0,0,6,2,0,8
2020-09-14,Waitemata,0,0,0,0,221,71,4,292
2020-09-14,West Coast,0,0,0,0,4,1,1,5
2020-09-14,Whanganui,0,0,0,0,8,1,0,9
2020-09-13,Auckland,0,0,0,0,212,51,1,263
2020-09-13,Bay of Plenty,0,0,0,0,34,14,0,48
2020-09-13,Canterbury,0,0,0,0,124,65,12,189
2020-09-13,Capital and Coast,0,0,0,0,72,24,2,96
2020-09-13,Counties Manukau,1,0,0,1,232,24,1,256
2020-09-13,Hawke's Bay,0,0,0,0,38,6,0,44
2020-09-13,Hutt Valley,0,0,0,0,19,3,0,22
2020-09-13,Lakes,0,0,0,0,15,1,0,16
2020-09-13,Midcentral,0,0,0,0,27,5,0,32
2020-09-13,Nelson Marlborough,0,0,0,0,37,12,0,49
2020-09-13,Northland,0,0,0,0,26,2,0,28
2020-09-13,South Canterbury,0,0,0,0,15,2,0,17
2020-09-13,Southern,0,0,0,0,186,30,2,216
2020-09-13,Tairawhiti,0,0,0,0,3,1,0,4
2020-09-13,Taranaki,0,0,0,0,14,2,0,16
2020-09-13,Waikato,0,0,0,0,154,34,1,188
2020-09-13,Wairarapa,0,0,0,0,6,2,0,8
2020-09-13,Waitemata,0,0,0,0,221,71,4,292
2020-09-13,West Coast,0,0,0,0,4,1,1,5
2020-09-13,Whanganui,0,0,0,0,8,1,0,9
2020-09-12,Auckland,0,0,0,0,212,51,1,263
2020-09-12,Bay of Plenty,0,0,0,0,34,14,0,48
2020-09-12,Canterbury,1,0,0,1,124,65,12,189
2020-09-12,Capital and Coast,0,0,0,0,72,24,2,96
2020-09-12,Counties Manukau,0,0,0,0,231,24,1,255
2020-09-12,Hawke's Bay,0,0,0,0,38,6,0,44
2020-09-12,Hutt Valley,0,0,0,0,19,3,0,22
2020-09-12,Lakes,0,0,0,0,15,1,0,16
2020-09-12,Midcentral,0,0,0,0,27,5,0,32
2020-09-12,Nelson Marlborough,0,0,0,0,37,12,0,49
2020-09-12,Northland,0,0,0,0,26,2,0,28
2020-09-12,South Canterbury,0,0,0,0,15,2,0,17
2020-09-12,Southern,0,0,0,0,186,30,2,216
2020-09-12,Tairawhiti,0,0,0,0,3,1,0,4
2020-09-12,Taranaki,0,0,0,0,14,2,0,16
2020-09-12,Waikato,0,0,0,0,154,34,1,188
2020-09-12,Wairarapa,0,0,0,0,6,2,0,8
2020-09-12,Waitemata,1,0,0,1,221,71,4,292
2020-09-12,West Coast,0,0,0,0,4,1,1,5
2020-09-12,Whanganui,0,0,0,0,8,1,0,9
2020-09-11,Auckland,0,0,0,0,212,51,1,263
2020-09-11,Bay of Plenty,0,0,0,0,34,14,0,48
2020-09-11,Canterbury,0,0,0,0,123,65,12,188
2020-09-11,Capital and Coast,0,0,0,0,72,24,2,96
2020-09-11,Counties Manukau,0,0,0,0,231,24,1,255
2020-09-11,Hawke's Bay,0,0,0,0,38,6,0,44
2020-09-11,Hutt Valley,0,0,0,0,19,3,0,22
2020-09-11,Lakes,0,0,0,0,15,1,0,16
2020-09-11,Midcentral,0,0,0,0,27,5,0,32
2020-09-11,Nelson Marlborough,0,0,0,0,37,12,0,49
2020-09-11,Northland,0,0,0,0,26,2,0,28
2020-09-11,South Canterbury,0,0,0,0,15,2,0,17
2020-09-11,Southern,0,0,0,0,186,30,2,216
2020-09-11,Tairawhiti,0,0,0,0,3,1,0,4
2020-09-11,Taranaki,0,0,0,0,14,2,0,16
2020-09-11,Waikato,0,0,0,0,154,34,1,188
2020-09-11,Wairarapa,0,0,0,0,6,2,0,8
2020-09-11,Waitemata,2,0,0,2,220,71,4,291
2020-09-11,West Coast,0,0,0,0,4,1,1,5
2020-09-11,Whanganui,0,0,0,0,8,1,0,9
2020-09-10,Auckland,1,0,0,1,212,51,1,263
2020-09-10,Bay of Plenty,0,0,0,0,34,14,0,48
2020-09-10,Canterbury,0,0,0,0,123,65,12,188
2020-09-10,Capital and Coast,0,0,0,0,72,24,2,96
2020-09-10,Counties Manukau,1,0,0,1,231,24,1,255
2020-09-10,Hawke's Bay,0,0,0,0,38,6,0,44
2020-09-10,Hutt Valley,0,0,0,0,19,3,0,22
2020-09-10,Lakes,0,0,0,0,15,1,0,16
2020-09-10,Midcentral,0,0,0,0,27,5,0,32
2020-09-10,Nelson Marlborough,0,0,0,0,37,12,0,49
2020-09-10,Northland,0,0,0,0,26,2,0,28
2020-09-10,South Canterbury,0,0,0,0,15,2,0,17
2020-09-10,Southern,0,0,0,0,186,30,2,216
2020-09-10,Tairawhiti,0,0,0,0,3,1,0,4
2020-09-10,Taranaki,0,0,0,0,14,2,0,16
2020-09-10,Waikato,0,0,0,0,154,34,1,188
2020-09-10,Wairarapa,0,0,0,0,6,2,0,8
2020-09-10,Waitemata,0,0,0,0,218,71,4,289
2020-09-10,West Coast,0,0,0,0,4,1,1,5
2020-09-10,Whanganui,0,0,0,0,8,1,0,9
2020-09-09,Auckland,0,0,0,0,211,51,1,262
2020-09-09,Bay of Plenty,0,0,0,0,34,14,0,48
2020-09-09,Canterbury,2,0,0,2,123,65,12,188
2020-09-09,Capital and Coast,0,0,0,0,72,24,2,96
2020-09-09,Counties Manukau,0,0,0,0,230,24,1,254
2020-09-09,Hawke's Bay,0,0,0,0,38,6,0,44
2020-09-09,Hutt Valley,0,0,0,0,19,3,0,22
2020-09-09,Lakes,0,0,0,0,15,1,0,16
2020-09-09,Midcentral,0,0,0,0,27,5,0,32
2020-09-09,Nelson Marlborough,0,0,0,0,37,12,0,49
2020-09-09,Northland,0,0,0,0,26,2,0,28
2020-09-09,South Canterbury,0,0,0,0,15,2,0,17
2020-09-09,Southern,0,0,0,0,186,30,2,216
2020-09-09,Tairawhiti,0,0,0,0,3,1,0,4
2020-09-09,Taranaki,0,0,0,0,14,2,0,16
2020-09-09,Waikato,0,0,0,0,154,34,1,188
2020-09-09,Wairarapa,0,0,0,0,6,2,0,8
2020-09-09,Waitemata,1,0,0,1,218,71,4,289
2020-09-09,West Coast,0,0,0,0,4,1,1,5
2020-09-09,Whanganui,0,0,0,0,8,1,0,9
2020-09-08,Auckland,2,0,0,2,211,51,1,262
2020-09-08,Bay of Plenty,0,0,0,0,34,14,0,48
2020-09-08,Canterbury,0,0,0,0,121,65,12,186
2020-09-08,Capital and Coast,0,0,0,0,72,24,2,96
2020-09-08,Counties Manukau,1,0,0,1,230,24,1,254
2020-09-08,Hawke's Bay,0,0,0,0,38,6,0,44
2020-09-08,Hutt Valley,0,0,0,0,19,3,0,22
2020-09-08,Lakes,0,0,0,0,15,1,0,16
2020-09-08,Midcentral,0,0,0,0,27,5,0,32
2020-09-08,Nelson Marlborough,0,0,0,0,37,12,0,49
2020-09-08,Northland,0,0,0,0,26,2,0,28
2020-09-08,South Canterbury,0,0,0,0,15,2,0,17
2020-09-08,Southern,0,0,0,0,186,30,2,216
2020-09-08,Tairawhiti,0,0,0,0,3,1,0,4
2020-09-08,Taranaki,0,0,0,0,14,2,0,16
2020-09-08,Waikato,0,0,0,0,154,34,1,188
2020-09-08,Wairarapa,0,0,0,0,6,2,0,8
2020-09-08,Waitemata,3,0,0,3,217,71,4,288
2020-09-08,West Coast,0,0,0,0,4,1,1,5
2020-09-08,Whanganui,0,0,0,0,8,1,0,9
2020-09-07,Auckland,0,0,0,0,209,51,1,260
2020-09-07,Bay of Plenty,0,0,0,0,34,14,0,48
2020-09-07,Canterbury,0,0,0,0,121,65,12,186
2020-09-07,Capital and Coast,0,0,0,0,72,24,2,96
2020-09-07,Counties Manukau,2,0,0,2,229,24,1,253
2020-09-07,Hawke's Bay,0,0,0,0,38,6,0,44
2020-09-07,Hutt Valley,0,0,0,0,19,3,0,22
2020-09-07,Lakes,0,0,0,0,15,1,0,16
2020-09-07,Midcentral,0,0,0,0,27,5,0,32
2020-09-07,Nelson Marlborough,0,0,0,0,37,12,0,49
2020-09-07,Northland,0,0,0,0,26,2,0,28
2020-09-07,South Canterbury,0,0,0,0,15,2,0,17
2020-09-07,Southern,0,0,0,0,186,30,2,216
2020-09-07,Tairawhiti,0,0,0,0,3,1,0,4
2020-09-07,Taranaki,0,0,0,0,14,2,0,16
2020-09-07,Waikato,0,0,0,0,154,34,1,188
2020-09-07,Wairarapa,0,0,0,0,6,2,0,8
2020-09-07,Waitemata,4,0,0,4,214,71,4,285
2020-09-07,West Coast,0,0,0,0,4,1,1,5
2020-09-07,Whanganui,0,0,0,0,8,1,0,9
2020-09-06,Auckland,0,0,0,0,209,51,1,260
2020-09-06,Bay of Plenty,0,0,0,0,34,14,0,48
2020-09-06,Canterbury,0,0,0,0,121,65,12,186
2020-09-06,Capital and Coast,0,0,0,0,72,24,2,96
2020-09-06,Counties Manukau,1,0,0,1,227,24,1,251
2020-09-06,Hawke's Bay,0,0,0,0,38,6,0,44
2020-09-06,Hutt Valley,0,0,0,0,19,3,0,22
2020-09-06,Lakes,0,0,0,0,15,1,0,16
2020-09-06,Midcentral,0,0,0,0,27,5,0,32
2020-09-06,Nelson Marlborough,0,0,0,0,37,12,0,49
2020-09-06,Northland,0,0,0,0,26,2,0,28
2020-09-06,South Canterbury,0,0,0,0,15,2,0,17
2020-09-06,Southern,0,0,0,0,186,30,2,216
2020-09-06,Tairawhiti,0,0,0,0,3,1,0,4
2020-09-06,Taranaki,0,0,0,0,14,2,0,16
2020-09-06,Waikato,0,0,0,0,154,34,1,188
2020-09-06,Wairarapa,0,0,0,0,6,2,0,8
2020-09-06,Waitemata,2,0,0,2,210,71,4,281
2020-09-06,West Coast,0,0,0,0,4,1,1,5
2020-09-06,Whanganui,0,0,0,0,8,1,0,9
2020-09-05,Auckland,2,0,1,2,209,51,1,260
2020-09-05,Bay of Plenty,0,0,0,0,34,14,0,48
2020-09-05,Canterbury,0,0,0,0,121,65,12,186
2020-09-05,Capital and Coast,0,0,0,0,72,24,2,96
2020-09-05,Counties Manukau,0,0,0,0,226,24,1,250
2020-09-05,Hawke's Bay,0,0,0,0,38,6,0,44
2020-09-05,Hutt Valley,0,0,0,0,19,3,0,22
2020-09-05,Lakes,0,0,0,0,15,1,0,16
2020-09-05,Midcentral,0,0,0,0,27,5,0,32
2020-09-05,Nelson Marlborough,0,0,0,0,37,12,0,49
2020-09-05,Northland,0,0,0,0,26,2,0,28
2020-09-05,South Canterbury,0,0,0,0,15,2,0,17
2020-09-05,Southern,0,0,0,0,186,30,2,216
2020-09-05,Tairawhiti,0,0,0,0,3,1,0,4
2020-09-05,Taranaki,0,0,0,0,14,2,0,16
2020-09-05,Waikato,0,0,0,0,154,34,1,188
2020-09-05,Wairarapa,0,0,0,0,6,2,0,8
2020-09-05,Waitemata,5,0,0,5,208,71,4,279
2020-09-05,West Coast,0,0,0,0,4,1,1,5
2020-09-05,Whanganui,0,0,0,0,8,1,0,9
2020-09-04,Auckland,1,0,0,1,207,51,0,258
2020-09-04,Bay of Plenty,0,0,0,0,34,14,0,48
2020-09-04,Canterbury,0,0,0,0,121,65,12,186
2020-09-04,Capital and Coast,0,0,0,0,72,24,2,96
2020-09-04,Counties Manukau,2,0,1,2,226,24,1,250
2020-09-04,Hawke's Bay,0,0,0,0,38,6,0,44
2020-09-04,Hutt Valley,0,0,0,0,19,3,0,22
2020-09-04,Lakes,0,0,0,0,15,1,0,16
2020-09-04,Midcentral,0,0,0,0,27,5,0,32
2020-09-04,Nelson Marlborough,0,0,0,0,37,12,0,49
2020-09-04,Northland,0,0,0,0,26,2,0,28
2020-09-04,South Canterbury,0,0,0,0,15,2,0,17
2020-09-04,Southern,0,0,0,0,186,30,2,216
2020-09-04,Tairawhiti,0,0,0,0,3,1,0,4
2020-09-04,Taranaki,0,0,0,0,14,2,0,16
2020-09-04,Waikato,0,0,0,0,154,34,1,188
2020-09-04,Wairarapa,0,0,0,0,6,2,0,8
2020-09-04,Waitemata,1,0,0,1,203,71,4,274
2020-09-04,West Coast,0,0,0,0,4,1,1,5
2020-09-04,Whanganui,0,0,0,0,8,1,0,9
2020-09-03,Auckland,0,0,0,0,206,51,0,257
2020-09-03,Bay of Plenty,0,0,0,0,34,14,0,48
2020-09-03,Canterbury,0,0,0,0,121,65,12,186
2020-09-03,Capital and Coast,0,0,0,0,72,24,2,96
2020-09-03,Counties Manukau,3,0,0,3,224,24,0,248
2020-09-03,Hawke's Bay,0,0,0,0,38,6,0,44
2020-09-03,Hutt Valley,0,0,0,0,19,3,0,22
2020-09-03,Lakes,0,0,0,0,15,1,0,16
2020-09-03,Midcentral,0,0,0,0,27,5,0,32
2020-09-03,Nelson Marlborough,0,0,0,0,37,12,0,49
2020-09-03,Northland,0,0,0,0,26,2,0,28
2020-09-03,South Canterbury,0,0,0,0,15,2,0,17
2020-09-03,Southern,0,0,0,0,186,30,2,216
2020-09-03,Tairawhiti,0,0,0,0,3,1,0,4
2020-09-03,Taranaki,0,0,0,0,14,2,0,16
2020-09-03,Waikato,0,0,0,0,154,34,1,188
2020-09-03,Wairarapa,0,0,0,0,6,2,0,8
2020-09-03,Waitemata,0,0,0,0,202,71,4,273
2020-09-03,West Coast,0,0,0,0,4,1,1,5
2020-09-03,Whanganui,0,0,0,0,8,1,0,9
2020-09-02,Auckland,2,0,0,2,206,51,0,257
2020-09-02,Bay of Plenty,0,0,0,0,34,14,0,48
2020-09-02,Canterbury,1,0,0,1,121,65,12,186
2020-09-02,Capital and Coast,0,0,0,0,72,24,2,96
2020-09-02,Counties Manukau,1,0,0,1,221,24,0,245
2020-09-02,Hawke's Bay,0,0,0,0,38,6,0,44
2020-09-02,Hutt Valley,0,0,0,0,19,3,0,22
2020-09-02,Lakes,0,0,0,0,15,1,0,16
2020-09-02,Midcentral,0,0,0,0,27,5,0,32
2020-09-02,Nelson Marlborough,0,0,0,0,37,12,0,49
2020-09-02,Northland,0,0,0,0,26,2,0,28
2020-09-02,South Canterbury,0,0,0,0,15,2,0,17
2020-09-02,Southern,0,0,0,0,186,30,2,216
2020-09-02,Tairawhiti,0,0,0,0,3,1,0,4
2020-09-02,Taranaki,0,0,0,0,14,2,0,16
2020-09-02,Waikato,0,0,0,0,154,34,1,188
2020-09-02,Wairarapa,0,0,0,0,6,2,0,8
2020-09-02,Waitemata,1,0,0,1,202,71,4,273
2020-09-02,West Coast,0,0,0,0,4,1,1,5
2020-09-02,Whanganui,0,0,0,0,8,1,0,9
2020-09-01,Auckland,0,0,0,0,204,51,0,255
2020-09-01,Bay of Plenty,0,0,0,0,34,14,0,48
2020-09-01,Canterbury,0,0,0,0,120,65,12,185
2020-09-01,Capital and Coast,0,0,0,0,72,24,2,96
2020-09-01,Counties Manukau,6,0,0,6,220,24,0,244
2020-09-01,Hawke's Bay,0,0,0,0,38,6,0,44
2020-09-01,Hutt Valley,0,0,0,0,19,3,0,22
2020-09-01,Lakes,0,0,0,0,15,1,0,16
2020-09-01,Midcentral,0,0,0,0,27,5,0,32
2020-09-01,Nelson Marlborough,0,0,0,0,37,12,0,49
2020-09-01,Northland,0,0,0,0,26,2,0,28
2020-09-01,South Canterbury,0,0,0,0,15,2,0,17
2020-09-01,Southern,0,0,0,0,186,30,2,216
2020-09-01,Tairawhiti,0,0,0,0,3,1,0,4
2020-09-01,Taranaki,0,0,0,0,14,2,0,16
2020-09-01,Waikato,0,0,0,0,154,34,1,188
2020-09-01,Wairarapa,0,0,0,0,6,2,0,8
2020-09-01,Waitemata,0,0,0,0,201,71,4,272
2020-09-01,West Coast,0,0,0,0,4,1,1,5
2020-09-01,Whanganui,0,0,0,0,8,1,0,9
2020-08-31,Auckland,0,0,0,0,204,51,0,255
2020-08-31,Bay of Plenty,0,0,0,0,34,14,0,48
2020-08-31,Canterbury,5,0,0,5,120,65,12,185
2020-08-31,Capital and Coast,1,0,0,1,72,24,2,96
2020-08-31,Counties Manukau,7,0,0,7,214,24,0,238
2020-08-31,Hawke's Bay,0,0,0,0,38,6,0,44
2020-08-31,Hutt Valley,0,0,0,0,19,3,0,22
2020-08-31,Lakes,0,0,0,0,15,1,0,16
2020-08-31,Midcentral,0,0,0,0,27,5,0,32
2020-08-31,Nelson Marlborough,0,0,0,0,37,12,0,49
2020-08-31,Northland,0,0,0,0,26,2,0,28
2020-08-31,South Canterbury,0,0,0,0,15,2,0,17
2020-08-31,Southern,0,0,0,0,186,30,2,216
2020-08-31,Tairawhiti,0,0,0,0,3,1,0,4
2020-08-31,Taranaki,0,0,0,0,14,2,0,16
2020-08-31,Waikato,0,0,0,0,154,34,1,188
2020-08-31,Wairarapa,0,0,0,0,6,2,0,8
2020-08-31,Waitemata,1,0,0,1,201,71,4,272
2020-08-31,West Coast,0,0,0,0,4,1,1,5
2020-08-31,Whanganui,0,0,0,0,8,1,0,9
2020-08-30,Auckland,3,0,0,3,204,51,0,255
2020-08-30,Bay of Plenty,0,0,0,0,34,14,0,48
2020-08-30,Canterbury,1,0,0,1,115,65,12,180
2020-08-30,Capital and Coast,0,0,0,0,71,24,2,95
2020-08-30,Counties Manukau,1,0,0,1,207,24,0,231
2020-08-30,Hawke's Bay,0,0,0,0,38,6,0,44
2020-08-30,Hutt Valley,0,0,0,0,19,3,0,22
2020-08-30,Lakes,0,0,0,0,15,1,0,16
2020-08-30,Midcentral,0,0,0,0,27,5,0,32
2020-08-30,Nelson Marlborough,0,0,0,0,37,12,0,49
2020-08-30,Northland,0,0,0,0,26,2,0,28
2020-08-30,South Canterbury,0,0,0,0,15,2,0,17
2020-08-30,Southern,0,0,0,0,186,30,2,216
2020-08-30,Tairawhiti,0,0,0,0,3,1,0,4
2020-08-30,Taranaki,0,0,0,0,14,2,0,16
2020-08-30,Waikato,0,0,0,0,154,34,1,188
2020-08-30,Wairarapa,0,0,0,0,6,2,0,8
2020-08-30,Waitemata,0,0,0,0,200,71,4,271
2020-08-30,West Coast,0,0,0,0,4,1,1,5
2020-08-30,Whanganui,0,0,0,0,8,1,0,9
2020-08-29,Auckland,1,0,0,1,201,51,0,252
2020-08-29,Bay of Plenty,0,0,0,0,34,14,0,48
2020-08-29,Canterbury,0,0,0,0,114,65,12,179
2020-08-29,Capital and Coast,0,0,0,0,71,24,2,95
2020-08-29,Counties Manukau,2,0,0,2,206,24,0,230
2020-08-29,Hawke's Bay,0,0,0,0,38,6,0,44
2020-08-29,Hutt Valley,0,0,0,0,19,3,0,22
2020-08-29,Lakes,0,0,0,0,15,1,0,16
2020-08-29,Midcentral,0,0,0,0,27,5,0,32
2020-08-29,Nelson Marlborough,0,0,0,0,37,12,0,49
2020-08-29,Northland,0,0,0,0,26,2,0,28
2020-08-29,South Canterbury,0,0,0,0,15,2,0,17
2020-08-29,Southern,0,0,0,0,186,30,2,216
2020-08-29,Tairawhiti,0,0,0,0,3,1,0,4
2020-08-29,Taranaki,0,0,0,0,14,2,0,16
2020-08-29,Waikato,0,0,0,0,154,34,1,188
2020-08-29,Wairarapa,0,0,0,0,6,2,0,8
2020-08-29,Waitemata,1,0,0,1,200,71,4,271
2020-08-29,West Coast,0,0,0,0,4,1,1,5
2020-08-29,Whanganui,0,0,0,0,8,1,0,9
2020-08-28,Auckland,10,0,0,10,200,51,0,251
2020-08-28,Bay of Plenty,0,0,0,0,34,14,0,48
2020-08-28,Canterbury,0,0,0,0,114,65,12,179
2020-08-28,Capital and Coast,0,0,0,0,71,24,2,95
2020-08-28,Counties Manukau,5,0,0,5,204,24,0,228
2020-08-28,Hawke's Bay,0,0,0,0,38,6,0,44
2020-08-28,Hutt Valley,0,0,0,0,19,3,0,22
2020-08-28,Lakes,0,0,0,0,15,1,0,16
2020-08-28,Midcentral,0,0,0,0,27,5,0,32
2020-08-28,Nelson Marlborough,0,0,0,0,37,12,0,49
2020-08-28,Northland,0,0,0,0,26,2,0,28
2020-08-28,South Canterbury,0,0,0,0,15,2,0,17
2020-08-28,Southern,0,0,0,0,186,30,2,216
2020-08-28,Tairawhiti,0,0,0,0,3,1,0,4
2020-08-28,Taranaki,0,0,0,0,14,2,0,16
2020-08-28,Waikato,0,0,0,0,154,34,1,188
2020-08-28,Wairarapa,0,0,0,0,6,2,0,8
2020-08-28,Waitemata,3,0,0,3,199,71,4,270
2020-08-28,West Coast,0,0,0,0,4,1,1,5
2020-08-28,Whanganui,0,0,0,0,8,1,0,9
2020-08-27,Auckland,0,0,0,0,190,51,0,241
2020-08-27,Bay of Plenty,0,0,0,0,34,14,0,48
2020-08-27,Canterbury,0,0,0,0,114,65,12,179
2020-08-27,Capital and Coast,0,0,0,0,71,24,2,95
2020-08-27,Counties Manukau,1,0,0,1,199,24,0,223
2020-08-27,Hawke's Bay,0,0,0,0,38,6,0,44
2020-08-27,Hutt Valley,0,0,0,0,19,3,0,22
2020-08-27,Lakes,0,0,0,0,15,1,0,16
2020-08-27,Midcentral,0,0,0,0,27,5,0,32
2020-08-27,Nelson Marlborough,0,0,0,0,37,12,0,49
2020-08-27,Northland,0,0,0,0,26,2,0,28
2020-08-27,South Canterbury,0,0,0,0,15,2,0,17
2020-08-27,Southern,0,0,0,0,186,30,2,216
2020-08-27,Tairawhiti,0,0,0,0,3,1,0,4
2020-08-27,Taranaki,0,0,0,0,14,2,0,16
2020-08-27,Waikato,0,0,0,0,154,34,1,188
2020-08-27,Wairarapa,0,0,0,0,6,2,0,8
2020-08-27,Waitemata,5,0,0,5,196,71,4,267
2020-08-27,West Coast,0,0,0,0,4,1,1,5
2020-08-27,Whanganui,0,0,0,0,8,1,0,9
2020-08-26,Auckland,3,0,0,3,190,51,0,241
2020-08-26,Bay of Plenty,0,0,0,0,34,14,0,48
2020-08-26,Canterbury,0,0,0,0,114,65,12,179
2020-08-26,Capital and Coast,0,0,0,0,71,24,2,95
2020-08-26,Counties Manukau,0,0,0,0,198,24,0,222
2020-08-26,Hawke's Bay,0,0,0,0,38,6,0,44
2020-08-26,Hutt Valley,0,0,0,0,19,3,0,22
2020-08-26,Lakes,0,0,0,0,15,1,0,16
2020-08-26,Midcentral,0,0,0,0,27,5,0,32
2020-08-26,Nelson Marlborough,0,0,0,0,37,12,0,49
2020-08-26,Northland,0,0,0,0,26,2,0,28
2020-08-26,South Canterbury,0,0,0,0,15,2,0,17
2020-08-26,Southern,0,0,0,0,186,30,2,216
2020-08-26,Tairawhiti,0,0,0,0,3,1,0,4
2020-08-26,Taranaki,0,0,0,0,14,2,0,16
2020-08-26,Waikato,0,0,0,0,154,34,1,188
2020-08-26,Wairarapa,0,0,0,0,6,2,0,8
2020-08-26,Waitemata,4,0,0,4,191,71,4,262
2020-08-26,West Coast,0,0,0,0,4,1,1,5
2020-08-26,Whanganui,0,0,0,0,8,1,0,9
2020-08-25,Auckland,0,0,0,0,187,51,0,238
2020-08-25,Bay of Plenty,0,0,0,0,34,14,0,48
2020-08-25,Canterbury,1,0,0,1,114,65,12,179
2020-08-25,Capital and Coast,0,0,0,0,71,24,2,95
2020-08-25,Counties Manukau,1,0,0,1,198,24,0,222
2020-08-25,Hawke's Bay,0,0,0,0,38,6,0,44
2020-08-25,Hutt Valley,0,0,0,0,19,3,0,22
2020-08-25,Lakes,0,0,0,0,15,1,0,16
2020-08-25,Midcentral,0,0,0,0,27,5,0,32
2020-08-25,Nelson Marlborough,0,0,0,0,37,12,0,49
2020-08-25,Northland,0,0,0,0,26,2,0,28
2020-08-25,South Canterbury,0,0,0,0,15,2,0,17
2020-08-25,Southern,0,0,0,0,186,30,2,216
2020-08-25,Tairawhiti,0,0,0,0,3,1,0,4
2020-08-25,Taranaki,0,0,0,0,14,2,0,16
2020-08-25,Waikato,0,0,0,0,154,34,1,188
2020-08-25,Wairarapa,0,0,0,0,6,2,0,8
2020-08-25,Waitemata,2,0,0,2,187,71,4,258
2020-08-25,West Coast,0,0,0,0,4,1,1,5
2020-08-25,Whanganui,0,0,0,0,8,1,0,9
2020-08-24,Auckland,3,0,0,3,187,51,0,238
2020-08-24,Bay of Plenty,0,0,0,0,34,14,0,48
2020-08-24,Canterbury,0,0,0,0,113,65,12,178
2020-08-24,Capital and Coast,0,0,0,0,71,24,2,95
2020-08-24,Counties Manukau,2,0,0,2,197,24,0,221
2020-08-24,Hawke's Bay,0,0,0,0,38,6,0,44
2020-08-24,Hutt Valley,0,0,0,0,19,3,0,22
2020-08-24,Lakes,0,0,0,0,15,1,0,16
2020-08-24,Midcentral,0,0,0,0,27,5,0,32
2020-08-24,Nelson Marlborough,0,0,0,0,37,12,0,49
2020-08-24,Northland,0,0,0,0,26,2,0,28
2020-08-24,South Canterbury,0,0,0,0,15,2,0,17
2020-08-24,Southern,0,0,0,0,186,30,2,216
2020-08-24,Tairawhiti,0,0,0,0,3,1,0,4
2020-08-24,Taranaki,0,0,0,0,14,2,0,16
2020-08-24,Waikato,0,0,0,0,154,34,1,188
2020-08-24,Wairarapa,0,0,0,0,6,2,0,8
2020-08-24,Waitemata,2,0,0,2,185,71,4,256
2020-08-24,West Coast,0,0,0,0,4,1,1,5
2020-08-24,Whanganui,0,0,0,0,8,1,0,9
2020-08-23,Auckland,2,0,0,2,184,51,0,235
2020-08-23,Bay of Plenty,0,0,0,0,34,14,0,48
2020-08-23,Canterbury,0,0,0,0,113,65,12,178
2020-08-23,Capital and Coast,0,0,0,0,71,24,2,95
2020-08-23,Counties Manukau,5,0,0,5,195,24,0,219
2020-08-23,Hawke's Bay,0,0,0,0,38,6,0,44
2020-08-23,Hutt Valley,0,0,0,0,19,3,0,22
2020-08-23,Lakes,0,0,0,0,15,1,0,16
2020-08-23,Midcentral,0,0,0,0,27,5,0,32
2020-08-23,Nelson Marlborough,0,0,0,0,37,12,0,49
2020-08-23,Northland,0,0,0,0,26,2,0,28
2020-08-23,South Canterbury,0,0,0,0,15,2,0,17
2020-08-23,Southern,0,0,0,0,186,30,2,216
2020-08-23,Tairawhiti,0,0,0,0,3,1,0,4
2020-08-23,Taranaki,0,0,0,0,14,2,0,16
2020-08-23,Waikato,0,0,0,0,154,34,1,188
2020-08-23,Wairarapa,0,0,0,0,6,2,0,8
2020-08-23,Waitemata,1,0,0,1,183,71,4,254
2020-08-23,West Coast,0,0,0,0,4,1,1,5
2020-08-23,Whanganui,0,0,0,0,8,1,0,9
2020-08-22,Auckland,2,0,0,2,182,51,0,233
2020-08-22,Bay of Plenty,0,0,0,0,34,14,0,48
2020-08-22,Canterbury,0,0,0,0,113,65,12,178
2020-08-22,Capital and Coast,0,0,0,0,71,24,2,95
2020-08-22,Counties Manukau,1,0,0,1,190,24,0,214
2020-08-22,Hawke's Bay,0,0,0,0,38,6,0,44
2020-08-22,Hutt Valley,0,0,0,0,19,3,0,22
2020-08-22,Lakes,0,0,0,0,15,1,0,16
2020-08-22,Midcentral,0,0,0,0,27,5,0,32
2020-08-22,Nelson Marlborough,0,0,0,0,37,12,0,49
2020-08-22,Northland,0,0,0,0,26,2,0,28
2020-08-22,South Canterbury,0,0,0,0,15,2,0,17
2020-08-22,Southern,0,0,0,0,186,30,2,216
2020-08-22,Tairawhiti,0,0,0,0,3,1,0,4
2020-08-22,Taranaki,0,0,0,0,14,2,0,16
2020-08-22,Waikato,0,0,0,0,154,34,1,188
2020-08-22,Wairarapa,0,0,0,0,6,2,0,8
2020-08-22,Waitemata,1,0,0,1,182,71,4,253
2020-08-22,West Coast,0,0,0,0,4,1,1,5
2020-08-22,Whanganui,0,0,0,0,8,1,0,9
2020-08-21,Auckland,1,0,0,1,180,51,0,231
2020-08-21,Bay of Plenty,0,0,0,0,34,14,0,48
2020-08-21,Canterbury,0,0,0,0,113,65,12,178
2020-08-21,Capital and Coast,0,0,0,0,71,24,2,95
2020-08-21,Counties Manukau,4,1,0,5,189,24,0,213
2020-08-21,Hawke's Bay,0,0,0,0,38,6,0,44
2020-08-21,Hutt Valley,0,0,0,0,19,3,0,22
2020-08-21,Lakes,0,0,0,0,15,1,0,16
2020-08-21,Midcentral,0,0,0,0,27,5,0,32
2020-08-21,Nelson Marlborough,0,0,0,0,37,12,0,49
2020-08-21,Northland,0,0,0,0,26,2,0,28
2020-08-21,South Canterbury,0,0,0,0,15,2,0,17
2020-08-21,Southern,0,0,0,0,186,30,2,216
2020-08-21,Tairawhiti,0,0,0,0,3,1,0,4
2020-08-21,Taranaki,0,0,0,0,14,2,0,16
2020-08-21,Waikato,0,0,0,0,154,34,1,188
2020-08-21,Wairarapa,0,0,0,0,6,2,0,8
2020-08-21,Waitemata,1,0,0,1,181,71,4,252
2020-08-21,West Coast,0,0,0,0,4,1,1,5
2020-08-21,Whanganui,0,0,0,0,8,1,0,9
2020-08-20,Auckland,1,0,0,1,179,51,0,230
2020-08-20,Bay of Plenty,0,0,0,0,34,14,0,48
2020-08-20,Canterbury,0,0,0,0,113,65,12,178
2020-08-20,Capital and Coast,0,0,0,0,71,24,2,95
2020-08-20,Counties Manukau,5,0,0,5,185,23,0,208
2020-08-20,Hawke's Bay,0,0,0,0,38,6,0,44
2020-08-20,Hutt Valley,0,0,0,0,19,3,0,22
2020-08-20,Lakes,0,0,0,0,15,1,0,16
2020-08-20,Midcentral,0,0,0,0,27,5,0,32
2020-08-20,Nelson Marlborough,0,0,0,0,37,12,0,49
2020-08-20,Northland,0,0,0,0,26,2,0,28
2020-08-20,South Canterbury,0,0,0,0,15,2,0,17
2020-08-20,Southern,0,0,0,0,186,30,2,216
2020-08-20,Tairawhiti,0,0,0,0,3,1,0,4
2020-08-20,Taranaki,0,0,0,0,14,2,0,16
2020-08-20,Waikato,0,0,0,0,154,34,1,188
2020-08-20,Wairarapa,0,0,0,0,6,2,0,8
2020-08-20,Waitemata,1,0,0,1,180,71,4,251
2020-08-20,West Coast,0,0,0,0,4,1,1,5
2020-08-20,Whanganui,0,0,0,0,8,1,0,9
2020-08-19,Auckland,0,0,0,0,178,51,0,229
2020-08-19,Bay of Plenty,0,0,0,0,34,14,0,48
2020-08-19,Canterbury,0,0,0,0,113,65,12,178
2020-08-19,Capital and Coast,0,0,0,0,71,24,2,95
2020-08-19,Counties Manukau,1,0,0,1,180,23,0,203
2020-08-19,Hawke's Bay,0,0,0,0,38,6,0,44
2020-08-19,Hutt Valley,0,0,0,0,19,3,0,22
2020-08-19,Lakes,0,0,0,0,15,1,0,16
2020-08-19,Midcentral,0,0,0,0,27,5,0,32
2020-08-19,Nelson Marlborough,0,0,0,0,37,12,0,49
2020-08-19,Northland,0,0,0,0,26,2,0,28
2020-08-19,South Canterbury,0,0,0,0,15,2,0,17
2020-08-19,Southern,0,0,0,0,186,30,2,216
2020-08-19,Tairawhiti,0,0,0,0,3,1,0,4
2020-08-19,Taranaki,0,0,0,0,14,2,0,16
2020-08-19,Waikato,1,0,0,1,154,34,1,188
2020-08-19,Wairarapa,0,0,0,0,6,2,0,8
2020-08-19,Waitemata,3,0,0,3,179,71,4,250
2020-08-19,West Coast,0,0,0,0,4,1,1,5
2020-08-19,Whanganui,0,0,0,0,8,1,0,9
2020-08-18,Auckland,5,0,0,5,178,51,0,229
2020-08-18,Bay of Plenty,0,0,0,0,34,14,0,48
2020-08-18,Canterbury,0,0,0,0,113,65,12,178
2020-08-18,Capital and Coast,0,0,0,0,71,24,2,95
2020-08-18,Counties Manukau,5,0,0,5,179,23,0,202
2020-08-18,Hawke's Bay,0,0,0,0,38,6,0,44
2020-08-18,Hutt Valley,0,0,0,0,19,3,0,22
2020-08-18,Lakes,0,0,0,0,15,1,0,16
2020-08-18,Midcentral,0,0,0,0,27,5,0,32
2020-08-18,Nelson Marlborough,0,0,0,0,37,12,0,49
2020-08-18,Northland,0,0,0,0,26,2,0,28
2020-08-18,South Canterbury,0,0,0,0,15,2,0,17
2020-08-18,Southern,0,0,0,0,186,30,2,216
2020-08-18,Tairawhiti,0,0,0,0,3,1,0,4
2020-08-18,Taranaki,0,0,0,0,14,2,0,16
2020-08-18,Waikato,0,0,0,0,153,34,1,187
2020-08-18,Wairarapa,0,0,0,0,6,2,0,8
2020-08-18,Waitemata,1,0,0,1,176,71,4,247
2020-08-18,West Coast,0,0,0,0,4,1,1,5
2020-08-18,Whanganui,0,0,0,0,8,1,0,9
2020-08-17,Auckland,4,0,0,4,173,51,0,224
2020-08-17,Bay of Plenty,0,0,0,0,34,14,0,48
2020-08-17,Canterbury,0,0,0,0,113,65,12,178
2020-08-17,Capital and Coast,0,0,0,0,71,24,2,95
2020-08-17,Counties Manukau,5,0,0,5,174,23,0,197
2020-08-17,Hawke's Bay,0,0,0,0,38,6,0,44
2020-08-17,Hutt Valley,0,0,0,0,19,3,0,22
2020-08-17,Lakes,0,0,0,0,15,1,0,16
2020-08-17,Midcentral,0,0,0,0,27,5,0,32
2020-08-17,Nelson Marlborough,0,0,0,0,37,12,0,49
2020-08-17,Northland,0,0,0,0,26,2,0,28
2020-08-17,South Canterbury,0,0,0,0,15,2,0,17
2020-08-17,Southern,0,0,0,0,186,30,2,216
2020-08-17,Tairawhiti,0,0,0,0,3,1,0,4
2020-08-17,Taranaki,0,0,0,0,14,2,0,16
2020-08-17,Waikato,0,0,0,0,153,34,1,187
2020-08-17,Wairarapa,0,0,0,0,6,2,0,8
2020-08-17,Waitemata,0,0,0,0,175,71,4,246
2020-08-17,West Coast,0,0,0,0,4,1,1,5
2020-08-17,Whanganui,0,0,0,0,8,1,0,9
2020-08-16,Auckland,8,0,0,8,169,51,0,220
2020-08-16,Bay of Plenty,0,0,0,0,34,14,0,48
2020-08-16,Canterbury,0,0,0,0,113,65,12,178
2020-08-16,Capital and Coast,0,0,0,0,71,24,2,95
2020-08-16,Counties Manukau,4,0,0,4,169,23,0,192
2020-08-16,Hawke's Bay,0,0,0,0,38,6,0,44
2020-08-16,Hutt Valley,0,0,0,0,19,3,0,22
2020-08-16,Lakes,0,0,0,0,15,1,0,16
2020-08-16,Midcentral,0,0,0,0,27,5,0,32
2020-08-16,Nelson Marlborough,0,0,0,0,37,12,0,49
2020-08-16,Northland,0,0,0,0,26,2,0,28
2020-08-16,South Canterbury,0,0,0,0,15,2,0,17
2020-08-16,Southern,0,0,0,0,186,30,2,216
2020-08-16,Tairawhiti,0,0,0,0,3,1,0,4
2020-08-16,Taranaki,0,0,0,0,14,2,0,16
2020-08-16,Waikato,0,0,0,0,153,34,1,187
2020-08-16,Wairarapa,0,0,0,0,6,2,0,8
2020-08-16,Waitemata,0,0,0,0,175,71,4,246
2020-08-16,West Coast,0,0,0,0,4,1,1,5
2020-08-16,Whanganui,0,0,0,0,8,1,0,9
2020-08-15,Auckland,5,0,0,5,161,51,0,212
2020-08-15,Bay of Plenty,0,0,0,0,34,14,0,48
2020-08-15,Canterbury,0,0,0,0,113,65,12,178
2020-08-15,Capital and Coast,0,0,0,0,71,24,2,95
2020-08-15,Counties Manukau,6,0,0,6,165,23,0,188
2020-08-15,Hawke's Bay,0,0,0,0,38,6,0,44
2020-08-15,Hutt Valley,0,0,0,0,19,3,0,22
2020-08-15,Lakes,0,0,0,0,15,1,0,16
2020-08-15,Midcentral,0,0,0,0,27,5,0,32
2020-08-15,Nelson Marlborough,0,0,0,0,37,12,0,49
2020-08-15,Northland,0,0,0,0,26,2,0,28
2020-08-15,South Canterbury,0,0,0,0,15,2,0,17
2020-08-15,Southern,0,0,0,0,186,30,2,216
2020-08-15,Tairawhiti,0,0,0,0,3,1,0,4
2020-08-15,Taranaki,0,0,0,0,14,2,0,16
2020-08-15,Waikato,0,0,0,0,153,34,1,187
2020-08-15,Wairarapa,0,0,0,0,6,2,0,8
2020-08-15,Waitemata,3,0,0,3,175,71,4,246
2020-08-15,West Coast,0,0,0,0,4,1,1,5
2020-08-15,Whanganui,0,0,0,0,8,1,0,9
2020-08-14,Auckland,4,0,0,4,156,51,0,207
2020-08-14,Bay of Plenty,0,0,0,0,34,14,0,48
2020-08-14,Canterbury,0,0,0,0,113,65,12,178
2020-08-14,Capital and Coast,0,0,0,0,71,24,2,95
2020-08-14,Counties Manukau,1,0,0,1,159,23,0,182
2020-08-14,Hawke's Bay,0,0,0,0,38,6,0,44
2020-08-14,Hutt Valley,0,0,0,0,19,3,0,22
2020-08-14,Lakes,0,0,0,0,15,1,0,16
2020-08-14,Midcentral,0,0,0,0,27,5,0,32
2020-08-14,Nelson Marlborough,0,0,0,0,37,12,0,49
2020-08-14,Northland,0,0,0,0,26,2,0,28
2020-08-14,South Canterbury,0,0,0,0,15,2,0,17
2020-08-14,Southern,0,0,0,0,186,30,2,216
2020-08-14,Tairawhiti,0,0,0,0,3,1,0,4
2020-08-14,Taranaki,0,0,0,0,14,2,0,16
2020-08-14,Waikato,0,0,0,0,153,34,1,187
2020-08-14,Wairarapa,0,0,0,0,6,2,0,8
2020-08-14,Waitemata,0,0,0,0,172,71,4,243
2020-08-14,West Coast,0,0,0,0,4,1,1,5
2020-08-14,Whanganui,0,0,0,0,8,1,0,9
2020-08-13,Auckland,3,0,0,3,152,51,0,203
2020-08-13,Bay of Plenty,0,0,0,0,34,14,0,48
2020-08-13,Canterbury,0,0,0,0,113,65,12,178
2020-08-13,Capital and Coast,0,0,0,0,71,24,2,95
2020-08-13,Counties Manukau,7,0,0,7,158,23,0,181
2020-08-13,Hawke's Bay,0,0,0,0,38,6,0,44
2020-08-13,Hutt Valley,0,0,0,0,19,3,0,22
2020-08-13,Lakes,0,0,0,0,15,1,0,16
2020-08-13,Midcentral,0,0,0,0,27,5,0,32
2020-08-13,Nelson Marlborough,0,0,0,0,37,12,0,49
2020-08-13,Northland,0,0,0,0,26,2,0,28
2020-08-13,South Canterbury,0,0,0,0,15,2,0,17
2020-08-13,Southern,0,0,0,0,186,30,2,216
2020-08-13,Tairawhiti,0,0,0,0,3,1,0,4
2020-08-13,Taranaki,0,0,0,0,14,2,0,16
2020-08-13,Waikato,0,0,0,0,153,34,1,187
2020-08-13,Wairarapa,0,0,0,0,6,2,0,8
2020-08-13,Waitemata,2,0,0,2,172,71,4,243
2020-08-13,West Coast,0,0,0,0,4,1,1,5
2020-08-13,Whanganui,0,0,0,0,8,1,0,9
2020-08-12,Auckland,1,0,0,1,149,51,0,200
2020-08-12,Bay of Plenty,0,0,0,0,34,14,0,48
2020-08-12,Canterbury,0,0,0,0,113,65,12,178
2020-08-12,Capital and Coast,0,0,0,0,71,24,2,95
2020-08-12,Counties Manukau,10,0,0,10,151,23,0,174
2020-08-12,Hawke's Bay,0,0,0,0,38,6,0,44
2020-08-12,Hutt Valley,0,0,0,0,19,3,0,22
2020-08-12,Lakes,0,0,0,0,15,1,0,16
2020-08-12,Midcentral,0,0,0,0,27,5,0,32
2020-08-12,Nelson Marlborough,0,0,0,0,37,12,0,49
2020-08-12,Northland,0,0,0,0,26,2,0,28
2020-08-12,South Canterbury,0,0,0,0,15,2,0,17
2020-08-12,Southern,0,0,0,0,186,30,2,216
2020-08-12,Tairawhiti,0,0,0,0,3,1,0,4
2020-08-12,Taranaki,0,0,0,0,14,2,0,16
2020-08-12,Waikato,0,0,0,0,153,34,1,187
2020-08-12,Wairarapa,0,0,0,0,6,2,0,8
2020-08-12,Waitemata,4,0,0,4,170,71,4,241
2020-08-12,West Coast,0,0,0,0,4,1,1,5
2020-08-12,Whanganui,0,0,0,0,8,1,0,9
2020-08-11,Auckland,1,0,0,1,148,51,0,199
2020-08-11,Bay of Plenty,0,0,0,0,34,14,0,48
2020-08-11,Canterbury,0,0,0,0,113,65,12,178
2020-08-11,Capital and Coast,0,0,0,0,71,24,2,95
2020-08-11,Counties Manukau,4,0,0,4,141,23,0,164
2020-08-11,Hawke's Bay,0,0,0,0,38,6,0,44
2020-08-11,Hutt Valley,0,0,0,0,19,3,0,22
2020-08-11,Lakes,0,0,0,0,15,1,0,16
2020-08-11,Midcentral,0,0,0,0,27,5,0,32
2020-08-11,Nelson Marlborough,0,0,0,0,37,12,0,49
2020-08-11,Northland,0,0,0,0,26,2,0,28
2020-08-11,South Canterbury,0,0,0,0,15,2,0,17
2020-08-11,Southern,0,0,0,0,186,30,2,216
2020-08-11,Tairawhiti,0,0,0,0,3,1,0,4
2020-08-11,Taranaki,0,0,0,0,14,2,0,16
2020-08-11,Waikato,0,0,0,0,153,34,1,187
2020-08-11,Wairarapa,0,0,0,0,6,2,0,8
2020-08-11,Waitemata,0,0,0,0,166,71,4,237
2020-08-11,West Coast,0,0,0,0,4,1,1,5
2020-08-11,Whanganui,0,0,0,0,8,1,0,9
2020-08-10,Auckland,0,0,0,0,147,51,0,198
2020-08-10,Bay of Plenty,0,0,0,0,34,14,0,48
2020-08-10,Canterbury,0,0,0,0,113,65,12,178
2020-08-10,Capital and Coast,0,0,0,0,71,24,2,95
2020-08-10,Counties Manukau,0,0,0,0,137,23,0,160
2020-08-10,Hawke's Bay,0,0,0,0,38,6,0,44
2020-08-10,Hutt Valley,0,0,0,0,19,3,0,22
2020-08-10,Lakes,0,0,0,0,15,1,0,16
2020-08-10,Midcentral,0,0,0,0,27,5,0,32
2020-08-10,Nelson Marlborough,0,0,0,0,37,12,0,49
2020-08-10,Northland,0,0,0,0,26,2,0,28
2020-08-10,South Canterbury,0,0,0,0,15,2,0,17
2020-08-10,Southern,0,0,0,0,186,30,2,216
2020-08-10,Tairawhiti,0,0,0,0,3,1,0,4
2020-08-10,Taranaki,0,0,0,0,14,2,0,16
2020-08-10,Waikato,0,0,0,0,153,34,1,187
2020-08-10,Wairarapa,0,0,0,0,6,2,0,8
2020-08-10,Waitemata,0,0,0,0,166,71,4,237
2020-08-10,West Coast,0,0,0,0,4,1,1,5
2020-08-10,Whanganui,0,0,0,0,8,1,0,9
2020-08-09,Auckland,0,0,0,0,147,51,0,198
2020-08-09,Bay of Plenty,0,0,0,0,34,14,0,48
2020-08-09,Canterbury,0,0,0,0,113,65,12,178
2020-08-09,Capital and Coast,0,0,0,0,71,24,2,95
2020-08-09,Counties Manukau,0,0,0,0,137,23,0,160
2020-08-09,Hawke's Bay,0,0,0,0,38,6,0,44
2020-08-09,Hutt Valley,0,0,0,0,19,3,0,22
2020-08-09,Lakes,0,0,0,0,15,1,0,16
2020-08-09,Midcentral,0,0,0,0,27,5,0,32
2020-08-09,Nelson Marlborough,0,0,0,0,37,12,0,49
2020-08-09,Northland,0,0,0,0,26,2,0,28
2020-08-09,South Canterbury,0,0,0,0,15,2,0,17
2020-08-09,Southern,0,0,0,0,186,30,2,216
2020-08-09,Tairawhiti,0,0,0,0,3,1,0,4
2020-08-09,Taranaki,0,0,0,0,14,2,0,16
2020-08-09,Waikato,0,0,0,0,153,34,1,187
2020-08-09,Wairarapa,0,0,0,0,6,2,0,8
2020-08-09,Waitemata,0,0,0,0,166,71,4,237
2020-08-09,West Coast,0,0,0,0,4,1,1,5
2020-08-09,Whanganui,0,0,0,0,8,1,0,9
2020-08-08,Auckland,0,0,0,0,147,51,0,198
2020-08-08,Bay of Plenty,0,0,0,0,34,14,0,48
2020-08-08,Canterbury,0,0,0,0,113,65,12,178
2020-08-08,Capital and Coast,0,0,0,0,71,24,2,95
2020-08-08,Counties Manukau,0,0,0,0,137,23,0,160
2020-08-08,Hawke's Bay,0,0,0,0,38,6,0,44
2020-08-08,Hutt Valley,0,0,0,0,19,3,0,22
2020-08-08,Lakes,0,0,0,0,15,1,0,16
2020-08-08,Midcentral,0,0,0,0,27,5,0,32
2020-08-08,Nelson Marlborough,0,0,0,0,37,12,0,49
2020-08-08,Northland,0,0,0,0,26,2,0,28
2020-08-08,South Canterbury,0,0,0,0,15,2,0,17
2020-08-08,Southern,0,0,0,0,186,30,2,216
2020-08-08,Tairawhiti,0,0,0,0,3,1,0,4
2020-08-08,Taranaki,0,0,0,0,14,2,0,16
2020-08-08,Waikato,0,0,0,0,153,34,1,187
2020-08-08,Wairarapa,0,0,0,0,6,2,0,8
2020-08-08,Waitemata,0,0,0,0,166,71,4,237
2020-08-08,West Coast,0,0,0,0,4,1,1,5
2020-08-08,Whanganui,0,0,0,0,8,1,0,9
2020-08-07,Auckland,0,0,0,0,147,51,0,198
2020-08-07,Bay of Plenty,0,0,0,0,34,14,0,48
2020-08-07,Canterbury,0,0,0,0,113,65,12,178
2020-08-07,Capital and Coast,0,0,0,0,71,24,2,95
2020-08-07,Counties Manukau,0,0,0,0,137,23,0,160
2020-08-07,Hawke's Bay,0,0,0,0,38,6,0,44
2020-08-07,Hutt Valley,0,0,0,0,19,3,0,22
2020-08-07,Lakes,0,0,0,0,15,1,0,16
2020-08-07,Midcentral,0,0,0,0,27,5,0,32
2020-08-07,Nelson Marlborough,0,0,0,0,37,12,0,49
2020-08-07,Northland,0,0,0,0,26,2,0,28
2020-08-07,South Canterbury,0,0,0,0,15,2,0,17
2020-08-07,Southern,0,0,0,0,186,30,2,216
2020-08-07,Tairawhiti,0,0,0,0,3,1,0,4
2020-08-07,Taranaki,0,0,0,0,14,2,0,16
2020-08-07,Waikato,0,0,0,0,153,34,1,187
2020-08-07,Wairarapa,0,0,0,0,6,2,0,8
2020-08-07,Waitemata,0,0,0,0,166,71,4,237
2020-08-07,West Coast,0,0,0,0,4,1,1,5
2020-08-07,Whanganui,0,0,0,0,8,1,0,9
2020-08-06,Auckland,0,0,0,0,147,51,0,198
2020-08-06,Bay of Plenty,0,0,0,0,34,14,0,48
2020-08-06,Canterbury,0,0,0,0,113,65,12,178
2020-08-06,Capital and Coast,0,0,0,0,71,24,2,95
2020-08-06,Counties Manukau,0,0,0,0,137,23,0,160
2020-08-06,Hawke's Bay,0,0,0,0,38,6,0,44
2020-08-06,Hutt Valley,0,0,0,0,19,3,0,22
2020-08-06,Lakes,0,0,0,0,15,1,0,16
2020-08-06,Midcentral,0,0,0,0,27,5,0,32
2020-08-06,Nelson Marlborough,0,0,0,0,37,12,0,49
2020-08-06,Northland,0,0,0,0,26,2,0,28
2020-08-06,South Canterbury,0,0,0,0,15,2,0,17
2020-08-06,Southern,0,0,0,0,186,30,2,216
2020-08-06,Tairawhiti,0,0,0,0,3,1,0,4
2020-08-06,Taranaki,0,0,0,0,14,2,0,16
2020-08-06,Waikato,0,0,0,0,153,34,1,187
2020-08-06,Wairarapa,0,0,0,0,6,2,0,8
2020-08-06,Waitemata,0,0,0,0,166,71,4,237
2020-08-06,West Coast,0,0,0,0,4,1,1,5
2020-08-06,Whanganui,0,0,0,0,8,1,0,9
2020-08-05,Auckland,0,0,0,0,147,51,0,198
2020-08-05,Bay of Plenty,0,0,0,0,34,14,0,48
2020-08-05,Canterbury,0,0,0,0,113,65,12,178
2020-08-05,Capital and Coast,0,0,0,0,71,24,2,95
2020-08-05,Counties Manukau,0,0,0,0,137,23,0,160
2020-08-05,Hawke's Bay,0,0,0,0,38,6,0,44
2020-08-05,Hutt Valley,0,0,0,0,19,3,0,22
2020-08-05,Lakes,0,0,0,0,15,1,0,16
2020-08-05,Midcentral,0,0,0,0,27,5,0,32
2020-08-05,Nelson Marlborough,0,0,0,0,37,12,0,49
2020-08-05,Northland,0,0,0,0,26,2,0,28
2020-08-05,South Canterbury,0,0,0,0,15,2,0,17
2020-08-05,Southern,0,0,0,0,186,30,2,216
2020-08-05,Tairawhiti,0,0,0,0,3,1,0,4
2020-08-05,Taranaki,0,0,0,0,14,2,0,16
2020-08-05,Waikato,0,0,0,0,153,34,1,187
2020-08-05,Wairarapa,0,0,0,0,6,2,0,8
2020-08-05,Waitemata,0,0,0,0,166,71,4,237
2020-08-05,West Coast,0,0,0,0,4,1,1,5
2020-08-05,Whanganui,0,0,0,0,8,1,0,9
2020-08-04,Auckland,1,0,0,1,147,51,0,198
2020-08-04,Bay of Plenty,0,0,0,0,34,14,0,48
2020-08-04,Canterbury,0,0,0,0,113,65,12,178
2020-08-04,Capital and Coast,0,0,0,0,71,24,2,95
2020-08-04,Counties Manukau,1,0,0,1,137,23,0,160
2020-08-04,Hawke's Bay,0,0,0,0,38,6,0,44
2020-08-04,Hutt Valley,0,0,0,0,19,3,0,22
2020-08-04,Lakes,0,0,0,0,15,1,0,16
2020-08-04,Midcentral,0,0,0,0,27,5,0,32
2020-08-04,Nelson Marlborough,0,0,0,0,37,12,0,49
2020-08-04,Northland,0,0,0,0,26,2,0,28
2020-08-04,South Canterbury,0,0,0,0,15,2,0,17
2020-08-04,Southern,0,0,0,0,186,30,2,216
2020-08-04,Tairawhiti,0,0,0,0,3,1,0,4
2020-08-04,Taranaki,0,0,0,0,14,2,0,16
2020-08-04,Waikato,0,0,0,0,153,34,1,187
2020-08-04,Wairarapa,0,0,0,0,6,2,0,8
2020-08-04,Waitemata,0,0,0,0,166,71,4,237
2020-08-04,West Coast,0,0,0,0,4,1,1,5
2020-08-04,Whanganui,0,0,0,0,8,1,0,9
2020-08-03,Auckland,0,0,0,0,146,51,0,197
2020-08-03,Bay of Plenty,0,0,0,0,34,14,0,48
2020-08-03,Canterbury,0,0,0,0,113,65,12,178
2020-08-03,Capital and Coast,0,0,0,0,71,24,2,95
2020-08-03,Counties Manukau,0,0,0,0,136,23,0,159
2020-08-03,Hawke's Bay,0,0,0,0,38,6,0,44
2020-08-03,Hutt Valley,0,0,0,0,19,3,0,22
2020-08-03,Lakes,0,0,0,0,15,1,0,16
2020-08-03,Midcentral,0,0,0,0,27,5,0,32
2020-08-03,Nelson Marlborough,0,0,0,0,37,12,0,49
2020-08-03,Northland,0,0,0,0,26,2,0,28
2020-08-03,South Canterbury,0,0,0,0,15,2,0,17
2020-08-03,Southern,0,0,0,0,186,30,2,216
2020-08-03,Tairawhiti,0,0,0,0,3,1,0,4
2020-08-03,Taranaki,0,0,0,0,14,2,0,16
2020-08-03,Waikato,0,0,0,0,153,34,1,187
2020-08-03,Wairarapa,0,0,0,0,6,2,0,8
2020-08-03,Waitemata,0,0,0,0,166,71,4,237
2020-08-03,West Coast,0,0,0,0,4,1,1,5
2020-08-03,Whanganui,0,0,0,0,8,1,0,9
2020-08-02,Auckland,0,0,0,0,146,51,0,197
2020-08-02,Bay of Plenty,0,0,0,0,34,14,0,48
2020-08-02,Canterbury,1,0,0,1,113,65,12,178
2020-08-02,Capital and Coast,0,0,0,0,71,24,2,95
2020-08-02,Counties Manukau,2,0,0,2,136,23,0,159
2020-08-02,Hawke's Bay,0,0,0,0,38,6,0,44
2020-08-02,Hutt Valley,0,0,0,0,19,3,0,22
2020-08-02,Lakes,0,0,0,0,15,1,0,16
2020-08-02,Midcentral,0,0,0,0,27,5,0,32
2020-08-02,Nelson Marlborough,0,0,0,0,37,12,0,49
2020-08-02,Northland,0,0,0,0,26,2,0,28
2020-08-02,South Canterbury,0,0,0,0,15,2,0,17
2020-08-02,Southern,0,0,0,0,186,30,2,216
2020-08-02,Tairawhiti,0,0,0,0,3,1,0,4
2020-08-02,Taranaki,0,0,0,0,14,2,0,16
2020-08-02,Waikato,0,0,0,0,153,34,1,187
2020-08-02,Wairarapa,0,0,0,0,6,2,0,8
2020-08-02,Waitemata,0,0,0,0,166,71,4,237
2020-08-02,West Coast,0,0,0,0,4,1,1,5
2020-08-02,Whanganui,0,0,0,0,8,1,0,9
2020-08-01,Auckland,1,0,0,1,146,51,0,197
2020-08-01,Bay of Plenty,0,0,0,0,34,14,0,48
2020-08-01,Canterbury,0,0,0,0,112,65,12,177
2020-08-01,Capital and Coast,0,0,0,0,71,24,2,95
2020-08-01,Counties Manukau,1,0,0,1,134,23,0,157
2020-08-01,Hawke's Bay,0,0,0,0,38,6,0,44
2020-08-01,Hutt Valley,0,0,0,0,19,3,0,22
2020-08-01,Lakes,0,0,0,0,15,1,0,16
2020-08-01,Midcentral,0,0,0,0,27,5,0,32
2020-08-01,Nelson Marlborough,0,0,0,0,37,12,0,49
2020-08-01,Northland,0,0,0,0,26,2,0,28
2020-08-01,South Canterbury,0,0,0,0,15,2,0,17
2020-08-01,Southern,0,0,0,0,186,30,2,216
2020-08-01,Tairawhiti,0,0,0,0,3,1,0,4
2020-08-01,Taranaki,0,0,0,0,14,2,0,16
2020-08-01,Waikato,0,0,0,0,153,34,1,187
2020-08-01,Wairarapa,0,0,0,0,6,2,0,8
2020-08-01,Waitemata,0,0,0,0,166,71,4,237
2020-08-01,West Coast,0,0,0,0,4,1,1,5
2020-08-01,Whanganui,0,0,0,0,8,1,0,9
2020-07-31,Auckland,0,0,0,0,145,51,0,196
2020-07-31,Bay of Plenty,0,0,0,0,34,14,0,48
2020-07-31,Canterbury,0,0,0,0,112,65,12,177
2020-07-31,Capital and Coast,0,0,0,0,71,24,2,95
2020-07-31,Counties Manukau,2,0,0,2,133,23,0,156
2020-07-31,Hawke's Bay,0,0,0,0,38,6,0,44
2020-07-31,Hutt Valley,0,0,0,0,19,3,0,22
2020-07-31,Lakes,0,0,0,0,15,1,0,16
2020-07-31,Midcentral,0,0,0,0,27,5,0,32
2020-07-31,Nelson Marlborough,0,0,0,0,37,12,0,49
2020-07-31,Northland,0,0,0,0,26,2,0,28
2020-07-31,South Canterbury,0,0,0,0,15,2,0,17
2020-07-31,Southern,0,0,0,0,186,30,2,216
2020-07-31,Tairawhiti,0,0,0,0,3,1,0,4
2020-07-31,Taranaki,0,0,0,0,14,2,0,16
2020-07-31,Waikato,0,0,0,0,153,34,1,187
2020-07-31,Wairarapa,0,0,0,0,6,2,0,8
2020-07-31,Waitemata,0,0,0,0,166,71,4,237
2020-07-31,West Coast,0,0,0,0,4,1,1,5
2020-07-31,Whanganui,0,0,0,0,8,1,0,9
2020-07-30,Auckland,0,0,0,0,145,51,0,196
2020-07-30,Bay of Plenty,0,0,0,0,34,14,0,48
2020-07-30,Canterbury,0,0,0,0,112,65,12,177
2020-07-30,Capital and Coast,0,0,0,0,71,24,2,95
2020-07-30,Counties Manukau,0,0,0,0,131,23,0,154
2020-07-30,Hawke's Bay,0,0,0,0,38,6,0,44
2020-07-30,Hutt Valley,0,0,0,0,19,3,0,22
2020-07-30,Lakes,0,0,0,0,15,1,0,16
2020-07-30,Midcentral,0,0,0,0,27,5,0,32
2020-07-30,Nelson Marlborough,0,0,0,0,37,12,0,49
2020-07-30,Northland,0,0,0,0,26,2,0,28
2020-07-30,South Canterbury,0,0,0,0,15,2,0,17
2020-07-30,Southern,0,0,0,0,186,30,2,216
2020-07-30,Tairawhiti,0,0,0,0,3,1,0,4
2020-07-30,Taranaki,0,0,0,0,14,2,0,16
2020-07-30,Waikato,0,0,0,0,153,34,1,187
2020-07-30,Wairarapa,0,0,0,0,6,2,0,8
2020-07-30,Waitemata,0,0,0,0,166,71,4,237
2020-07-30,West Coast,0,0,0,0,4,1,1,5
2020-07-30,Whanganui,0,0,0,0,8,1,0,9
2020-07-29,Auckland,0,0,0,0,145,51,0,196
2020-07-29,Bay of Plenty,0,0,0,0,34,14,0,48
2020-07-29,Canterbury,0,0,0,0,112,65,12,177
2020-07-29,Capital and Coast,0,0,0,0,71,24,2,95
2020-07-29,Counties Manukau,1,0,0,1,131,23,0,154
2020-07-29,Hawke's Bay,0,0,0,0,38,6,0,44
2020-07-29,Hutt Valley,0,0,0,0,19,3,0,22
2020-07-29,Lakes,0,0,0,0,15,1,0,16
2020-07-29,Midcentral,0,0,0,0,27,5,0,32
2020-07-29,Nelson Marlborough,0,0,0,0,37,12,0,49
2020-07-29,Northland,0,0,0,0,26,2,0,28
2020-07-29,South Canterbury,0,0,0,0,15,2,0,17
2020-07-29,Southern,0,0,0,0,186,30,2,216
2020-07-29,Tairawhiti,0,0,0,0,3,1,0,4
2020-07-29,Taranaki,0,0,0,0,14,2,0,16
2020-07-29,Waikato,0,0,0,0,153,34,1,187
2020-07-29,Wairarapa,0,0,0,0,6,2,0,8
2020-07-29,Waitemata,0,0,0,0,166,71,4,237
2020-07-29,West Coast,0,0,0,0,4,1,1,5
2020-07-29,Whanganui,0,0,0,0,8,1,0,9
2020-07-28,Auckland,0,0,0,0,145,51,0,196
2020-07-28,Bay of Plenty,0,0,0,0,34,14,0,48
2020-07-28,Canterbury,0,0,0,0,112,65,12,177
2020-07-28,Capital and Coast,0,0,0,0,71,24,2,95
2020-07-28,Counties Manukau,1,0,0,1,130,23,0,153
2020-07-28,Hawke's Bay,0,0,0,0,38,6,0,44
2020-07-28,Hutt Valley,0,0,0,0,19,3,0,22
2020-07-28,Lakes,0,0,0,0,15,1,0,16
2020-07-28,Midcentral,0,0,0,0,27,5,0,32
2020-07-28,Nelson Marlborough,0,0,0,0,37,12,0,49
2020-07-28,Northland,0,0,0,0,26,2,0,28
2020-07-28,South Canterbury,0,0,0,0,15,2,0,17
2020-07-28,Southern,0,0,0,0,186,30,2,216
2020-07-28,Tairawhiti,0,0,0,0,3,1,0,4
2020-07-28,Taranaki,0,0,0,0,14,2,0,16
2020-07-28,Waikato,0,0,0,0,153,34,1,187
2020-07-28,Wairarapa,0,0,0,0,6,2,0,8
2020-07-28,Waitemata,0,0,0,0,166,71,4,237
2020-07-28,West Coast,0,0,0,0,4,1,1,5
2020-07-28,Whanganui,0,0,0,0,8,1,0,9
2020-07-27,Auckland,0,0,0,0,145,51,0,196
2020-07-27,Bay of Plenty,0,0,0,0,34,14,0,48
2020-07-27,Canterbury,0,0,0,0,112,65,12,177
2020-07-27,Capital and Coast,0,0,0,0,71,24,2,95
2020-07-27,Counties Manukau,2,0,0,2,129,23,0,152
2020-07-27,Hawke's Bay,0,0,0,0,38,6,0,44
2020-07-27,Hutt Valley,0,0,0,0,19,3,0,22
2020-07-27,Lakes,0,0,0,0,15,1,0,16
2020-07-27,Midcentral,0,0,0,0,27,5,0,32
2020-07-27,Nelson Marlborough,0,0,0,0,37,12,0,49
2020-07-27,Northland,0,0,0,0,26,2,0,28
2020-07-27,South Canterbury,0,0,0,0,15,2,0,17
2020-07-27,Southern,0,0,0,0,186,30,2,216
2020-07-27,Tairawhiti,0,0,0,0,3,1,0,4
2020-07-27,Taranaki,0,0,0,0,14,2,0,16
2020-07-27,Waikato,0,0,0,0,153,34,1,187
2020-07-27,Wairarapa,0,0,0,0,6,2,0,8
2020-07-27,Waitemata,0,0,0,0,166,71,4,237
2020-07-27,West Coast,0,0,0,0,4,1,1,5
2020-07-27,Whanganui,0,0,0,0,8,1,0,9
2020-07-26,Auckland,0,0,0,0,145,51,0,196
2020-07-26,Bay of Plenty,0,0,0,0,34,14,0,48
2020-07-26,Canterbury,0,0,0,0,112,65,12,177
2020-07-26,Capital and Coast,0,0,0,0,71,24,2,95
2020-07-26,Counties Manukau,0,0,0,0,127,23,0,150
2020-07-26,Hawke's Bay,0,0,0,0,38,6,0,44
2020-07-26,Hutt Valley,0,0,0,0,19,3,0,22
2020-07-26,Lakes,0,0,0,0,15,1,0,16
2020-07-26,Midcentral,0,0,0,0,27,5,0,32
2020-07-26,Nelson Marlborough,0,0,0,0,37,12,0,49
2020-07-26,Northland,0,0,0,0,26,2,0,28
2020-07-26,South Canterbury,0,0,0,0,15,2,0,17
2020-07-26,Southern,0,0,0,0,186,30,2,216
2020-07-26,Tairawhiti,0,0,0,0,3,1,0,4
2020-07-26,Taranaki,0,0,0,0,14,2,0,16
2020-07-26,Waikato,0,0,0,0,153,34,1,187
2020-07-26,Wairarapa,0,0,0,0,6,2,0,8
2020-07-26,Waitemata,0,0,0,0,166,71,4,237
2020-07-26,West Coast,0,0,0,0,4,1,1,5
2020-07-26,Whanganui,0,0,0,0,8,1,0,9
2020-07-25,Auckland,0,0,0,0,145,51,0,196
2020-07-25,Bay of Plenty,0,0,0,0,34,14,0,48
2020-07-25,Canterbury,0,0,0,0,112,65,12,177
2020-07-25,Capital and Coast,0,0,0,0,71,24,2,95
2020-07-25,Counties Manukau,0,0,0,0,127,23,0,150
2020-07-25,Hawke's Bay,0,0,0,0,38,6,0,44
2020-07-25,Hutt Valley,0,0,0,0,19,3,0,22
2020-07-25,Lakes,0,0,0,0,15,1,0,16
2020-07-25,Midcentral,0,0,0,0,27,5,0,32
2020-07-25,Nelson Marlborough,0,0,0,0,37,12,0,49
2020-07-25,Northland,0,0,0,0,26,2,0,28
2020-07-25,South Canterbury,0,0,0,0,15,2,0,17
2020-07-25,Southern,0,0,0,0,186,30,2,216
2020-07-25,Tairawhiti,0,0,0,0,3,1,0,4
2020-07-25,Taranaki,0,0,0,0,14,2,0,16
2020-07-25,Waikato,0,0,0,0,153,34,1,187
2020-07-25,Wairarapa,0,0,0,0,6,2,0,8
2020-07-25,Waitemata,0,0,0,0,166,71,4,237
2020-07-25,West Coast,0,0,0,0,4,1,1,5
2020-07-25,Whanganui,0,0,0,0,8,1,0,9
2020-07-24,Auckland,0,0,0,0,145,51,0,196
2020-07-24,Bay of Plenty,0,0,0,0,34,14,0,48
2020-07-24,Canterbury,0,0,0,0,112,65,12,177
2020-07-24,Capital and Coast,0,0,0,0,71,24,2,95
2020-07-24,Counties Manukau,1,0,0,1,127,23,0,150
2020-07-24,Hawke's Bay,0,0,0,0,38,6,0,44
2020-07-24,Hutt Valley,0,0,0,0,19,3,0,22
2020-07-24,Lakes,0,0,0,0,15,1,0,16
2020-07-24,Midcentral,0,0,0,0,27,5,0,32
2020-07-24,Nelson Marlborough,0,0,0,0,37,12,0,49
2020-07-24,Northland,0,0,0,0,26,2,0,28
2020-07-24,South Canterbury,0,0,0,0,15,2,0,17
2020-07-24,Southern,0,0,0,0,186,30,2,216
2020-07-24,Tairawhiti,0,0,0,0,3,1,0,4
2020-07-24,Taranaki,0,0,0,0,14,2,0,16
2020-07-24,Waikato,0,0,0,0,153,34,1,187
2020-07-24,Wairarapa,0,0,0,0,6,2,0,8
2020-07-24,Waitemata,0,0,0,0,166,71,4,237
2020-07-24,West Coast,0,0,0,0,4,1,1,5
2020-07-24,Whanganui,0,0,0,0,8,1,0,9
2020-07-23,Auckland,0,0,0,0,145,51,0,196
2020-07-23,Bay of Plenty,0,0,0,0,34,14,0,48
2020-07-23,Canterbury,0,0,0,0,112,65,12,177
2020-07-23,Capital and Coast,0,0,0,0,71,24,2,95
2020-07-23,Counties Manukau,0,0,0,0,126,23,0,149
2020-07-23,Hawke's Bay,0,0,0,0,38,6,0,44
2020-07-23,Hutt Valley,0,0,0,0,19,3,0,22
2020-07-23,Lakes,0,0,0,0,15,1,0,16
2020-07-23,Midcentral,0,0,0,0,27,5,0,32
2020-07-23,Nelson Marlborough,0,0,0,0,37,12,0,49
2020-07-23,Northland,0,0,0,0,26,2,0,28
2020-07-23,South Canterbury,0,0,0,0,15,2,0,17
2020-07-23,Southern,0,0,0,0,186,30,2,216
2020-07-23,Tairawhiti,0,0,0,0,3,1,0,4
2020-07-23,Taranaki,0,0,0,0,14,2,0,16
2020-07-23,Waikato,0,0,0,0,153,34,1,187
2020-07-23,Wairarapa,0,0,0,0,6,2,0,8
2020-07-23,Waitemata,0,0,0,0,166,71,4,237
2020-07-23,West Coast,0,0,0,0,4,1,1,5
2020-07-23,Whanganui,0,0,0,0,8,1,0,9
2020-07-22,Auckland,0,0,0,0,145,51,0,196
2020-07-22,Bay of Plenty,0,0,0,0,34,14,0,48
2020-07-22,Canterbury,0,0,0,0,112,65,12,177
2020-07-22,Capital and Coast,0,0,0,0,71,24,2,95
2020-07-22,Counties Manukau,0,0,0,0,126,23,0,149
2020-07-22,Hawke's Bay,0,0,0,0,38,6,0,44
2020-07-22,Hutt Valley,0,0,0,0,19,3,0,22
2020-07-22,Lakes,0,0,0,0,15,1,0,16
2020-07-22,Midcentral,0,0,0,0,27,5,0,32
2020-07-22,Nelson Marlborough,0,0,0,0,37,12,0,49
2020-07-22,Northland,0,0,0,0,26,2,0,28
2020-07-22,South Canterbury,0,0,0,0,15,2,0,17
2020-07-22,Southern,0,0,0,0,186,30,2,216
2020-07-22,Tairawhiti,0,0,0,0,3,1,0,4
2020-07-22,Taranaki,0,0,0,0,14,2,0,16
2020-07-22,Waikato,0,0,0,0,153,34,1,187
2020-07-22,Wairarapa,0,0,0,0,6,2,0,8
2020-07-22,Waitemata,0,0,0,0,166,71,4,237
2020-07-22,West Coast,0,0,0,0,4,1,1,5
2020-07-22,Whanganui,0,0,0,0,8,1,0,9
2020-07-21,Auckland,0,0,0,0,145,51,0,196
2020-07-21,Bay of Plenty,0,0,0,0,34,14,0,48
2020-07-21,Canterbury,0,0,0,0,112,65,12,177
2020-07-21,Capital and Coast,0,0,0,0,71,24,2,95
2020-07-21,Counties Manukau,0,0,0,0,126,23,0,149
2020-07-21,Hawke's Bay,0,0,0,0,38,6,0,44
2020-07-21,Hutt Valley,0,0,0,0,19,3,0,22
2020-07-21,Lakes,0,0,0,0,15,1,0,16
2020-07-21,Midcentral,0,0,0,0,27,5,0,32
2020-07-21,Nelson Marlborough,0,0,0,0,37,12,0,49
2020-07-21,Northland,0,0,0,0,26,2,0,28
2020-07-21,South Canterbury,0,0,0,0,15,2,0,17
2020-07-21,Southern,0,0,0,0,186,30,2,216
2020-07-21,Tairawhiti,0,0,0,0,3,1,0,4
2020-07-21,Taranaki,0,0,0,0,14,2,0,16
2020-07-21,Waikato,0,0,0,0,153,34,1,187
2020-07-21,Wairarapa,0,0,0,0,6,2,0,8
2020-07-21,Waitemata,0,0,0,0,166,71,4,237
2020-07-21,West Coast,0,0,0,0,4,1,1,5
2020-07-21,Whanganui,0,0,0,0,8,1,0,9
2020-07-20,Auckland,1,0,0,1,145,51,0,196
2020-07-20,Bay of Plenty,0,0,0,0,34,14,0,48
2020-07-20,Canterbury,0,0,0,0,112,65,12,177
2020-07-20,Capital and Coast,0,0,0,0,71,24,2,95
2020-07-20,Counties Manukau,0,0,0,0,126,23,0,149
2020-07-20,Hawke's Bay,0,0,0,0,38,6,0,44
2020-07-20,Hutt Valley,0,0,0,0,19,3,0,22
2020-07-20,Lakes,0,0,0,0,15,1,0,16
2020-07-20,Midcentral,0,0,0,0,27,5,0,32
2020-07-20,Nelson Marlborough,0,0,0,0,37,12,0,49
2020-07-20,Northland,0,0,0,0,26,2,0,28
2020-07-20,South Canterbury,0,0,0,0,15,2,0,17
2020-07-20,Southern,0,0,0,0,186,30,2,216
2020-07-20,Tairawhiti,0,0,0,0,3,1,0,4
2020-07-20,Taranaki,0,0,0,0,14,2,0,16
2020-07-20,Waikato,0,0,0,0,153,34,1,187
2020-07-20,Wairarapa,0,0,0,0,6,2,0,8
2020-07-20,Waitemata,0,0,0,0,166,71,4,237
2020-07-20,West Coast,0,0,0,0,4,1,1,5
2020-07-20,Whanganui,0,0,0,0,8,1,0,9
2020-07-19,Auckland,1,0,0,1,144,51,0,195
2020-07-19,Bay of Plenty,0,0,0,0,34,14,0,48
2020-07-19,Canterbury,0,0,0,0,112,65,12,177
2020-07-19,Capital and Coast,0,0,0,0,71,24,2,95
2020-07-19,Counties Manukau,0,0,0,0,126,23,0,149
2020-07-19,Hawke's Bay,0,0,0,0,38,6,0,44
2020-07-19,Hutt Valley,0,0,0,0,19,3,0,22
2020-07-19,Lakes,0,0,0,0,15,1,0,16
2020-07-19,Midcentral,0,0,0,0,27,5,0,32
2020-07-19,Nelson Marlborough,0,0,0,0,37,12,0,49
2020-07-19,Northland,0,0,0,0,26,2,0,28
2020-07-19,South Canterbury,0,0,0,0,15,2,0,17
2020-07-19,Southern,0,0,0,0,186,30,2,216
2020-07-19,Tairawhiti,0,0,0,0,3,1,0,4
2020-07-19,Taranaki,0,0,0,0,14,2,0,16
2020-07-19,Waikato,0,0,0,0,153,34,1,187
2020-07-19,Wairarapa,0,0,0,0,6,2,0,8
2020-07-19,Waitemata,0,0,0,0,166,71,4,237
2020-07-19,West Coast,0,0,0,0,4,1,1,5
2020-07-19,Whanganui,0,0,0,0,8,1,0,9
2020-07-18,Auckland,0,0,0,0,143,51,0,194
2020-07-18,Bay of Plenty,0,0,0,0,34,14,0,48
2020-07-18,Canterbury,0,0,0,0,112,65,12,177
2020-07-18,Capital and Coast,0,0,0,0,71,24,2,95
2020-07-18,Counties Manukau,2,0,0,2,126,23,0,149
2020-07-18,Hawke's Bay,0,0,0,0,38,6,0,44
2020-07-18,Hutt Valley,0,0,0,0,19,3,0,22
2020-07-18,Lakes,0,0,0,0,15,1,0,16
2020-07-18,Midcentral,0,0,0,0,27,5,0,32
2020-07-18,Nelson Marlborough,0,0,0,0,37,12,0,49
2020-07-18,Northland,0,0,0,0,26,2,0,28
2020-07-18,South Canterbury,0,0,0,0,15,2,0,17
2020-07-18,Southern,0,0,0,0,186,30,2,216
2020-07-18,Tairawhiti,0,0,0,0,3,1,0,4
2020-07-18,Taranaki,0,0,0,0,14,2,0,16
2020-07-18,Waikato,0,0,0,0,153,34,1,187
2020-07-18,Wairarapa,0,0,0,0,6,2,0,8
2020-07-18,Waitemata,0,0,0,0,166,71,4,237
2020-07-18,West Coast,0,0,0,0,4,1,1,5
2020-07-18,Whanganui,0,0,0,0,8,1,0,9
2020-07-17,Auckland,0,0,0,0,143,51,0,194
2020-07-17,Bay of Plenty,0,0,0,0,34,14,0,48
2020-07-17,Canterbury,1,0,0,1,112,65,12,177
2020-07-17,Capital and Coast,0,0,0,0,71,24,2,95
2020-07-17,Counties Manukau,1,0,0,1,124,23,0,147
2020-07-17,Hawke's Bay,0,0,0,0,38,6,0,44
2020-07-17,Hutt Valley,0,0,0,0,19,3,0,22
2020-07-17,Lakes,0,0,0,0,15,1,0,16
2020-07-17,Midcentral,0,0,0,0,27,5,0,32
2020-07-17,Nelson Marlborough,0,0,0,0,37,12,0,49
2020-07-17,Northland,0,0,0,0,26,2,0,28
2020-07-17,South Canterbury,0,0,0,0,15,2,0,17
2020-07-17,Southern,0,0,0,0,186,30,2,216
2020-07-17,Tairawhiti,0,0,0,0,3,1,0,4
2020-07-17,Taranaki,0,0,0,0,14,2,0,16
2020-07-17,Waikato,0,0,0,0,153,34,1,187
2020-07-17,Wairarapa,0,0,0,0,6,2,0,8
2020-07-17,Waitemata,0,0,0,0,166,71,4,237
2020-07-17,West Coast,0,0,0,0,4,1,1,5
2020-07-17,Whanganui,0,0,0,0,8,1,0,9
2020-07-16,Auckland,0,0,0,0,143,51,0,194
2020-07-16,Bay of Plenty,0,0,0,0,34,14,0,48
2020-07-16,Canterbury,0,0,0,0,111,65,12,176
2020-07-16,Capital and Coast,0,0,0,0,71,24,2,95
2020-07-16,Counties Manukau,1,0,0,1,123,23,0,146
2020-07-16,Hawke's Bay,0,0,0,0,38,6,0,44
2020-07-16,Hutt Valley,0,0,0,0,19,3,0,22
2020-07-16,Lakes,0,0,0,0,15,1,0,16
2020-07-16,Midcentral,0,0,0,0,27,5,0,32
2020-07-16,Nelson Marlborough,0,0,0,0,37,12,0,49
2020-07-16,Northland,0,0,0,0,26,2,0,28
2020-07-16,South Canterbury,0,0,0,0,15,2,0,17
2020-07-16,Southern,0,0,0,0,186,30,2,216
2020-07-16,Tairawhiti,0,0,0,0,3,1,0,4
2020-07-16,Taranaki,0,0,0,0,14,2,0,16
2020-07-16,Waikato,0,0,0,0,153,34,1,187
2020-07-16,Wairarapa,0,0,0,0,6,2,0,8
2020-07-16,Waitemata,0,0,0,0,166,71,4,237
2020-07-16,West Coast,0,0,0,0,4,1,1,5
2020-07-16,Whanganui,0,0,0,0,8,1,0,9
2020-07-15,Auckland,0,0,0,0,143,51,0,194
2020-07-15,Bay of Plenty,0,0,0,0,34,14,0,48
2020-07-15,Canterbury,0,0,0,0,111,65,12,176
2020-07-15,Capital and Coast,0,0,0,0,71,24,2,95
2020-07-15,Counties Manukau,0,0,0,0,122,23,0,145
2020-07-15,Hawke's Bay,0,0,0,0,38,6,0,44
2020-07-15,Hutt Valley,0,0,0,0,19,3,0,22
2020-07-15,Lakes,0,0,0,0,15,1,0,16
2020-07-15,Midcentral,0,0,0,0,27,5,0,32
2020-07-15,Nelson Marlborough,0,0,0,0,37,12,0,49
2020-07-15,Northland,0,0,0,0,26,2,0,28
2020-07-15,South Canterbury,0,0,0,0,15,2,0,17
2020-07-15,Southern,0,0,0,0,186,30,2,216
2020-07-15,Tairawhiti,0,0,0,0,3,1,0,4
2020-07-15,Taranaki,0,0,0,0,14,2,0,16
2020-07-15,Waikato,0,0,0,0,153,34,1,187
2020-07-15,Wairarapa,0,0,0,0,6,2,0,8
2020-07-15,Waitemata,0,0,0,0,166,71,4,237
2020-07-15,West Coast,0,0,0,0,4,1,1,5
2020-07-15,Whanganui,0,0,0,0,8,1,0,9
2020-07-14,Auckland,0,0,0,0,143,51,0,194
2020-07-14,Bay of Plenty,0,0,0,0,34,14,0,48
2020-07-14,Canterbury,1,0,0,1,111,65,12,176
2020-07-14,Capital and Coast,0,0,0,0,71,24,2,95
2020-07-14,Counties Manukau,2,0,0,2,122,23,0,145
2020-07-14,Hawke's Bay,0,0,0,0,38,6,0,44
2020-07-14,Hutt Valley,0,0,0,0,19,3,0,22
2020-07-14,Lakes,0,0,0,0,15,1,0,16
2020-07-14,Midcentral,0,0,0,0,27,5,0,32
2020-07-14,Nelson Marlborough,0,0,0,0,37,12,0,49
2020-07-14,Northland,0,0,0,0,26,2,0,28
2020-07-14,South Canterbury,0,0,0,0,15,2,0,17
2020-07-14,Southern,0,0,0,0,186,30,2,216
2020-07-14,Tairawhiti,0,0,0,0,3,1,0,4
2020-07-14,Taranaki,0,0,0,0,14,2,0,16
2020-07-14,Waikato,0,0,0,0,153,34,1,187
2020-07-14,Wairarapa,0,0,0,0,6,2,0,8
2020-07-14,Waitemata,0,0,0,0,166,71,4,237
2020-07-14,West Coast,0,0,0,0,4,1,1,5
2020-07-14,Whanganui,0,0,0,0,8,1,0,9
2020-07-13,Auckland,0,0,0,0,143,51,0,194
2020-07-13,Bay of Plenty,0,0,0,0,34,14,0,48
2020-07-13,Canterbury,1,0,0,1,110,65,12,175
2020-07-13,Capital and Coast,0,0,0,0,71,24,2,95
2020-07-13,Counties Manukau,0,0,0,0,120,23,0,143
2020-07-13,Hawke's Bay,0,0,0,0,38,6,0,44
2020-07-13,Hutt Valley,0,0,0,0,19,3,0,22
2020-07-13,Lakes,0,0,0,0,15,1,0,16
2020-07-13,Midcentral,0,0,0,0,27,5,0,32
2020-07-13,Nelson Marlborough,0,0,0,0,37,12,0,49
2020-07-13,Northland,0,0,0,0,26,2,0,28
2020-07-13,South Canterbury,0,0,0,0,15,2,0,17
2020-07-13,Southern,0,0,0,0,186,30,2,216
2020-07-13,Tairawhiti,0,0,0,0,3,1,0,4
2020-07-13,Taranaki,0,0,0,0,14,2,0,16
2020-07-13,Waikato,0,0,0,0,153,34,1,187
2020-07-13,Wairarapa,0,0,0,0,6,2,0,8
2020-07-13,Waitemata,0,0,0,0,166,71,4,237
2020-07-13,West Coast,0,0,0,0,4,1,1,5
2020-07-13,Whanganui,0,0,0,0,8,1,0,9
2020-07-12,Auckland,0,0,0,0,143,51,0,194
2020-07-12,Bay of Plenty,0,0,0,0,34,14,0,48
2020-07-12,Canterbury,0,0,0,0,109,65,12,174
2020-07-12,Capital and Coast,0,0,0,0,71,24,2,95
2020-07-12,Counties Manukau,0,0,0,0,120,23,0,143
2020-07-12,Hawke's Bay,0,0,0,0,38,6,0,44
2020-07-12,Hutt Valley,0,0,0,0,19,3,0,22
2020-07-12,Lakes,0,0,0,0,15,1,0,16
2020-07-12,Midcentral,0,0,0,0,27,5,0,32
2020-07-12,Nelson Marlborough,0,0,0,0,37,12,0,49
2020-07-12,Northland,0,0,0,0,26,2,0,28
2020-07-12,South Canterbury,0,0,0,0,15,2,0,17
2020-07-12,Southern,0,0,0,0,186,30,2,216
2020-07-12,Tairawhiti,0,0,0,0,3,1,0,4
2020-07-12,Taranaki,0,0,0,0,14,2,0,16
2020-07-12,Waikato,0,0,0,0,153,34,1,187
2020-07-12,Wairarapa,0,0,0,0,6,2,0,8
2020-07-12,Waitemata,0,0,0,0,166,71,4,237
2020-07-12,West Coast,0,0,0,0,4,1,1,5
2020-07-12,Whanganui,0,0,0,0,8,1,0,9
2020-07-11,Auckland,0,0,0,0,143,51,0,194
2020-07-11,Bay of Plenty,0,0,0,0,34,14,0,48
2020-07-11,Canterbury,1,0,0,1,109,65,12,174
2020-07-11,Capital and Coast,0,0,0,0,71,24,2,95
2020-07-11,Counties Manukau,0,0,0,0,120,23,0,143
2020-07-11,Hawke's Bay,0,0,0,0,38,6,0,44
2020-07-11,Hutt Valley,0,0,0,0,19,3,0,22
2020-07-11,Lakes,0,0,0,0,15,1,0,16
2020-07-11,Midcentral,0,0,0,0,27,5,0,32
2020-07-11,Nelson Marlborough,0,0,0,0,37,12,0,49
2020-07-11,Northland,0,0,0,0,26,2,0,28
2020-07-11,South Canterbury,0,0,0,0,15,2,0,17
2020-07-11,Southern,0,0,0,0,186,30,2,216
2020-07-11,Tairawhiti,0,0,0,0,3,1,0,4
2020-07-11,Taranaki,0,0,0,0,14,2,0,16
2020-07-11,Waikato,0,0,0,0,153,34,1,187
2020-07-11,Wairarapa,0,0,0,0,6,2,0,8
2020-07-11,Waitemata,0,0,0,0,166,71,4,237
2020-07-11,West Coast,0,0,0,0,4,1,1,5
2020-07-11,Whanganui,0,0,0,0,8,1,0,9
2020-07-10,Auckland,0,0,0,0,143,51,0,194
2020-07-10,Bay of Plenty,0,0,0,0,34,14,0,48
2020-07-10,Canterbury,0,0,0,0,108,65,12,173
2020-07-10,Capital and Coast,0,0,0,0,71,24,2,95
2020-07-10,Counties Manukau,0,0,0,0,120,23,0,143
2020-07-10,Hawke's Bay,0,0,0,0,38,6,0,44
2020-07-10,Hutt Valley,0,0,0,0,19,3,0,22
2020-07-10,Lakes,0,0,0,0,15,1,0,16
2020-07-10,Midcentral,0,0,0,0,27,5,0,32
2020-07-10,Nelson Marlborough,0,0,0,0,37,12,0,49
2020-07-10,Northland,0,0,0,0,26,2,0,28
2020-07-10,South Canterbury,0,0,0,0,15,2,0,17
2020-07-10,Southern,0,0,0,0,186,30,2,216
2020-07-10,Tairawhiti,0,0,0,0,3,1,0,4
2020-07-10,Taranaki,0,0,0,0,14,2,0,16
2020-07-10,Waikato,0,0,0,0,153,34,1,187
2020-07-10,Wairarapa,0,0,0,0,6,2,0,8
2020-07-10,Waitemata,0,0,0,0,166,71,4,237
2020-07-10,West Coast,0,0,0,0,4,1,1,5
2020-07-10,Whanganui,0,0,0,0,8,1,0,9
2020-07-09,Auckland,0,0,0,0,143,51,0,194
2020-07-09,Bay of Plenty,0,0,0,0,34,14,0,48
2020-07-09,Canterbury,1,0,0,1,108,65,12,173
2020-07-09,Capital and Coast,0,0,0,0,71,24,2,95
2020-07-09,Counties Manukau,2,0,0,2,120,23,0,143
2020-07-09,Hawke's Bay,0,0,0,0,38,6,0,44
2020-07-09,Hutt Valley,0,0,0,0,19,3,0,22
2020-07-09,Lakes,0,0,0,0,15,1,0,16
2020-07-09,Midcentral,0,0,0,0,27,5,0,32
2020-07-09,Nelson Marlborough,0,0,0,0,37,12,0,49
2020-07-09,Northland,0,0,0,0,26,2,0,28
2020-07-09,South Canterbury,0,0,0,0,15,2,0,17
2020-07-09,Southern,0,0,0,0,186,30,2,216
2020-07-09,Tairawhiti,0,0,0,0,3,1,0,4
2020-07-09,Taranaki,0,0,0,0,14,2,0,16
2020-07-09,Waikato,0,0,0,0,153,34,1,187
2020-07-09,Wairarapa,0,0,0,0,6,2,0,8
2020-07-09,Waitemata,0,0,0,0,166,71,4,237
2020-07-09,West Coast,0,0,0,0,4,1,1,5
2020-07-09,Whanganui,0,0,0,0,8,1,0,9
2020-07-08,Auckland,1,0,0,1,143,51,0,194
2020-07-08,Bay of Plenty,0,0,0,0,34,14,0,48
2020-07-08,Canterbury,1,0,0,1,107,65,12,172
2020-07-08,Capital and Coast,0,0,0,0,71,24,2,95
2020-07-08,Counties Manukau,0,0,0,0,118,23,0,141
2020-07-08,Hawke's Bay,0,0,0,0,38,6,0,44
2020-07-08,Hutt Valley,0,0,0,0,19,3,0,22
2020-07-08,Lakes,0,0,0,0,15,1,0,16
2020-07-08,Midcentral,0,0,0,0,27,5,0,32
2020-07-08,Nelson Marlborough,0,0,0,0,37,12,0,49
2020-07-08,Northland,0,0,0,0,26,2,0,28
2020-07-08,South Canterbury,0,0,0,0,15,2,0,17
2020-07-08,Southern,0,0,0,0,186,30,2,216
2020-07-08,Tairawhiti,0,0,0,0,3,1,0,4
2020-07-08,Taranaki,0,0,0,0,14,2,0,16
2020-07-08,Waikato,0,0,0,0,153,34,1,187
2020-07-08,Wairarapa,0,0,0,0,6,2,0,8
2020-07-08,Waitemata,0,0,0,0,166,71,4,237
2020-07-08,West Coast,0,0,0,0,4,1,1,5
2020-07-08,Whanganui,0,0,0,0,8,1,0,9
2020-07-07,Auckland,2,0,0,2,142,51,0,193
2020-07-07,Bay of Plenty,0,0,0,0,34,14,0,48
2020-07-07,Canterbury,0,0,0,0,106,65,12,171
2020-07-07,Capital and Coast,0,0,0,0,71,24,2,95
2020-07-07,Counties Manukau,0,0,0,0,118,23,0,141
2020-07-07,Hawke's Bay,0,0,0,0,38,6,0,44
2020-07-07,Hutt Valley,0,0,0,0,19,3,0,22
2020-07-07,Lakes,0,0,0,0,15,1,0,16
2020-07-07,Midcentral,0,0,0,0,27,5,0,32
2020-07-07,Nelson Marlborough,0,0,0,0,37,12,0,49
2020-07-07,Northland,0,0,0,0,26,2,0,28
2020-07-07,South Canterbury,0,0,0,0,15,2,0,17
2020-07-07,Southern,0,0,0,0,186,30,2,216
2020-07-07,Tairawhiti,0,0,0,0,3,1,0,4
2020-07-07,Taranaki,0,0,0,0,14,2,0,16
2020-07-07,Waikato,0,0,0,0,153,34,1,187
2020-07-07,Wairarapa,0,0,0,0,6,2,0,8
2020-07-07,Waitemata,0,0,0,0,166,71,4,237
2020-07-07,West Coast,0,0,0,0,4,1,1,5
2020-07-07,Whanganui,0,0,0,0,8,1,0,9
2020-07-06,Auckland,0,0,0,0,140,51,0,191
2020-07-06,Bay of Plenty,0,0,0,0,34,14,0,48
2020-07-06,Canterbury,2,0,0,2,106,65,12,171
2020-07-06,Capital and Coast,0,0,0,0,71,24,2,95
2020-07-06,Counties Manukau,1,0,0,1,118,23,0,141
2020-07-06,Hawke's Bay,0,0,0,0,38,6,0,44
2020-07-06,Hutt Valley,0,0,0,0,19,3,0,22
2020-07-06,Lakes,0,0,0,0,15,1,0,16
2020-07-06,Midcentral,0,0,0,0,27,5,0,32
2020-07-06,Nelson Marlborough,0,0,0,0,37,12,0,49
2020-07-06,Northland,0,0,0,0,26,2,0,28
2020-07-06,South Canterbury,0,0,0,0,15,2,0,17
2020-07-06,Southern,0,0,0,0,186,30,2,216
2020-07-06,Tairawhiti,0,0,0,0,3,1,0,4
2020-07-06,Taranaki,0,0,0,0,14,2,0,16
2020-07-06,Waikato,0,0,0,0,153,34,1,187
2020-07-06,Wairarapa,0,0,0,0,6,2,0,8
2020-07-06,Waitemata,0,0,0,0,166,71,4,237
2020-07-06,West Coast,0,0,0,0,4,1,1,5
2020-07-06,Whanganui,0,0,0,0,8,1,0,9
2020-07-05,Auckland,0,0,0,0,140,51,0,191
2020-07-05,Bay of Plenty,0,0,0,0,34,14,0,48
2020-07-05,Canterbury,3,0,0,3,104,65,12,169
2020-07-05,Capital and Coast,0,0,0,0,71,24,2,95
2020-07-05,Counties Manukau,0,0,0,0,117,23,0,140
2020-07-05,Hawke's Bay,0,0,0,0,38,6,0,44
2020-07-05,Hutt Valley,0,0,0,0,19,3,0,22
2020-07-05,Lakes,0,0,0,0,15,1,0,16
2020-07-05,Midcentral,0,0,0,0,27,5,0,32
2020-07-05,Nelson Marlborough,0,0,0,0,37,12,0,49
2020-07-05,Northland,0,0,0,0,26,2,0,28
2020-07-05,South Canterbury,0,0,0,0,15,2,0,17
2020-07-05,Southern,0,0,0,0,186,30,2,216
2020-07-05,Tairawhiti,0,0,0,0,3,1,0,4
2020-07-05,Taranaki,0,0,0,0,14,2,0,16
2020-07-05,Waikato,0,0,0,0,153,34,1,187
2020-07-05,Wairarapa,0,0,0,0,6,2,0,8
2020-07-05,Waitemata,0,0,0,0,166,71,4,237
2020-07-05,West Coast,0,0,0,0,4,1,1,5
2020-07-05,Whanganui,0,0,0,0,8,1,0,9
2020-07-04,Auckland,0,0,0,0,140,51,0,191
2020-07-04,Bay of Plenty,0,0,0,0,34,14,0,48
2020-07-04,Canterbury,0,0,0,0,101,65,12,166
2020-07-04,Capital and Coast,0,0,0,0,71,24,2,95
2020-07-04,Counties Manukau,0,0,0,0,117,23,0,140
2020-07-04,Hawke's Bay,0,0,0,0,38,6,0,44
2020-07-04,Hutt Valley,0,0,0,0,19,3,0,22
2020-07-04,Lakes,0,0,0,0,15,1,0,16
2020-07-04,Midcentral,0,0,0,0,27,5,0,32
2020-07-04,Nelson Marlborough,0,0,0,0,37,12,0,49
2020-07-04,Northland,0,0,0,0,26,2,0,28
2020-07-04,South Canterbury,0,0,0,0,15,2,0,17
2020-07-04,Southern,0,0,0,0,186,30,2,216
2020-07-04,Tairawhiti,0,0,0,0,3,1,0,4
2020-07-04,Taranaki,0,0,0,0,14,2,0,16
2020-07-04,Waikato,0,0,0,0,153,34,1,187
2020-07-04,Wairarapa,0,0,0,0,6,2,0,8
2020-07-04,Waitemata,0,0,0,0,166,71,4,237
2020-07-04,West Coast,0,0,0,0,4,1,1,5
2020-07-04,Whanganui,0,0,0,0,8,1,0,9
2020-07-03,Auckland,0,0,0,0,140,51,0,191
2020-07-03,Bay of Plenty,0,0,0,0,34,14,0,48
2020-07-03,Canterbury,0,0,0,0,101,65,12,166
2020-07-03,Capital and Coast,0,0,0,0,71,24,2,95
2020-07-03,Counties Manukau,0,0,0,0,117,23,0,140
2020-07-03,Hawke's Bay,0,0,0,0,38,6,0,44
2020-07-03,Hutt Valley,0,0,0,0,19,3,0,22
2020-07-03,Lakes,0,0,0,0,15,1,0,16
2020-07-03,Midcentral,0,0,0,0,27,5,0,32
2020-07-03,Nelson Marlborough,0,0,0,0,37,12,0,49
2020-07-03,Northland,0,0,0,0,26,2,0,28
2020-07-03,South Canterbury,0,0,0,0,15,2,0,17
2020-07-03,Southern,0,0,0,0,186,30,2,216
2020-07-03,Tairawhiti,0,0,0,0,3,1,0,4
2020-07-03,Taranaki,0,0,0,0,14,2,0,16
2020-07-03,Waikato,0,0,0,0,153,34,1,187
2020-07-03,Wairarapa,0,0,0,0,6,2,0,8
2020-07-03,Waitemata,0,0,0,0,166,71,4,237
2020-07-03,West Coast,0,0,0,0,4,1,1,5
2020-07-03,Whanganui,0,0,0,0,8,1,0,9
2020-07-02,Auckland,0,0,0,0,140,51,0,191
2020-07-02,Bay of Plenty,0,0,0,0,34,14,0,48
2020-07-02,Canterbury,0,0,0,0,101,65,12,166
2020-07-02,Capital and Coast,0,0,0,0,71,24,2,95
2020-07-02,Counties Manukau,1,0,0,1,117,23,0,140
2020-07-02,Hawke's Bay,0,0,0,0,38,6,0,44
2020-07-02,Hutt Valley,0,0,0,0,19,3,0,22
2020-07-02,Lakes,0,0,0,0,15,1,0,16
2020-07-02,Midcentral,0,0,0,0,27,5,0,32
2020-07-02,Nelson Marlborough,0,0,0,0,37,12,0,49
2020-07-02,Northland,0,0,0,0,26,2,0,28
2020-07-02,South Canterbury,0,0,0,0,15,2,0,17
2020-07-02,Southern,0,0,0,0,186,30,2,216
2020-07-02,Tairawhiti,0,0,0,0,3,1,0,4
2020-07-02,Taranaki,0,0,0,0,14,2,0,16
2020-07-02,Waikato,0,0,0,0,153,34,1,187
2020-07-02,Wairarapa,0,0,0,0,6,2,0,8
2020-07-02,Waitemata,0,0,0,0,166,71,4,237
2020-07-02,West Coast,0,0,0,0,4,1,1,5
2020-07-02,Whanganui,0,0,0,0,8,1,0,9
2020-07-01,Auckland,1,0,0,1,140,51,0,191
2020-07-01,Bay of Plenty,0,0,0,0,34,14,0,48
2020-07-01,Canterbury,0,0,0,0,101,65,12,166
2020-07-01,Capital and Coast,0,0,0,0,71,24,2,95
2020-07-01,Counties Manukau,0,0,0,0,116,23,0,139
2020-07-01,Hawke's Bay,0,0,0,0,38,6,0,44
2020-07-01,Hutt Valley,0,0,0,0,19,3,0,22
2020-07-01,Lakes,0,0,0,0,15,1,0,16
2020-07-01,Midcentral,0,0,0,0,27,5,0,32
2020-07-01,Nelson Marlborough,0,0,0,0,37,12,0,49
2020-07-01,Northland,0,0,0,0,26,2,0,28
2020-07-01,South Canterbury,0,0,0,0,15,2,0,17
2020-07-01,Southern,0,0,0,0,186,30,2,216
2020-07-01,Tairawhiti,0,0,0,0,3,1,0,4
2020-07-01,Taranaki,0,0,0,0,14,2,0,16
2020-07-01,Waikato,0,0,0,0,153,34,1,187
2020-07-01,Wairarapa,0,0,0,0,6,2,0,8
2020-07-01,Waitemata,0,0,0,0,166,71,4,237
2020-07-01,West Coast,0,0,0,0,4,1,1,5
2020-07-01,Whanganui,0,0,0,0,8,1,0,9
2020-06-30,Auckland,0,0,0,0,139,51,0,190
2020-06-30,Bay of Plenty,0,0,0,0,34,14,0,48
2020-06-30,Canterbury,0,0,0,0,101,65,12,166
2020-06-30,Capital and Coast,0,0,0,0,71,24,2,95
2020-06-30,Counties Manukau,0,0,0,0,116,23,0,139
2020-06-30,Hawke's Bay,0,0,0,0,38,6,0,44
2020-06-30,Hutt Valley,0,0,0,0,19,3,0,22
2020-06-30,Lakes,0,0,0,0,15,1,0,16
2020-06-30,Midcentral,0,0,0,0,27,5,0,32
2020-06-30,Nelson Marlborough,0,0,0,0,37,12,0,49
2020-06-30,Northland,0,0,0,0,26,2,0,28
2020-06-30,South Canterbury,0,0,0,0,15,2,0,17
2020-06-30,Southern,0,0,0,0,186,30,2,216
2020-06-30,Tairawhiti,0,0,0,0,3,1,0,4
2020-06-30,Taranaki,0,0,0,0,14,2,0,16
2020-06-30,Waikato,0,0,0,0,153,34,1,187
2020-06-30,Wairarapa,0,0,0,0,6,2,0,8
2020-06-30,Waitemata,0,0,0,0,166,71,4,237
2020-06-30,West Coast,0,0,0,0,4,1,1,5
2020-06-30,Whanganui,0,0,0,0,8,1,0,9
2020-06-29,Auckland,0,0,0,0,139,51,0,190
2020-06-29,Bay of Plenty,0,0,0,0,34,14,0,48
2020-06-29,Canterbury,0,0,0,0,101,65,12,166
2020-06-29,Capital and Coast,0,0,0,0,71,24,2,95
2020-06-29,Counties Manukau,1,0,0,1,116,23,0,139
2020-06-29,Hawke's Bay,0,0,0,0,38,6,0,44
2020-06-29,Hutt Valley,0,0,0,0,19,3,0,22
2020-06-29,Lakes,0,0,0,0,15,1,0,16
2020-06-29,Midcentral,0,0,0,0,27,5,0,32
2020-06-29,Nelson Marlborough,0,0,0,0,37,12,0,49
2020-06-29,Northland,0,0,0,0,26,2,0,28
2020-06-29,South Canterbury,0,0,0,0,15,2,0,17
2020-06-29,Southern,0,0,0,0,186,30,2,216
2020-06-29,Tairawhiti,0,0,0,0,3,1,0,4
2020-06-29,Taranaki,0,0,0,0,14,2,0,16
2020-06-29,Waikato,0,0,0,0,153,34,1,187
2020-06-29,Wairarapa,0,0,0,0,6,2,0,8
2020-06-29,Waitemata,0,0,0,0,166,71,4,237
2020-06-29,West Coast,0,0,0,0,4,1,1,5
2020-06-29,Whanganui,0,0,0,0,8,1,0,9
2020-06-28,Auckland,1,0,0,1,139,51,0,190
2020-06-28,Bay of Plenty,0,0,0,0,34,14,0,48
2020-06-28,Canterbury,0,0,0,0,101,65,12,166
2020-06-28,Capital and Coast,0,0,0,0,71,24,2,95
2020-06-28,Counties Manukau,0,0,0,0,115,23,0,138
2020-06-28,Hawke's Bay,0,0,0,0,38,6,0,44
2020-06-28,Hutt Valley,0,0,0,0,19,3,0,22
2020-06-28,Lakes,0,0,0,0,15,1,0,16
2020-06-28,Midcentral,0,0,0,0,27,5,0,32
2020-06-28,Nelson Marlborough,0,0,0,0,37,12,0,49
2020-06-28,Northland,0,0,0,0,26,2,0,28
2020-06-28,South Canterbury,0,0,0,0,15,2,0,17
2020-06-28,Southern,0,0,0,0,186,30,2,216
2020-06-28,Tairawhiti,0,0,0,0,3,1,0,4
2020-06-28,Taranaki,0,0,0,0,14,2,0,16
2020-06-28,Waikato,0,0,0,0,153,34,1,187
2020-06-28,Wairarapa,0,0,0,0,6,2,0,8
2020-06-28,Waitemata,0,0,0,0,166,71,4,237
2020-06-28,West Coast,0,0,0,0,4,1,1,5
2020-06-28,Whanganui,0,0,0,0,8,1,0,9
2020-06-27,Auckland,4,0,0,4,138,51,0,189
2020-06-27,Bay of Plenty,0,0,0,0,34,14,0,48
2020-06-27,Canterbury,0,0,0,0,101,65,12,166
2020-06-27,Capital and Coast,0,0,0,0,71,24,2,95
2020-06-27,Counties Manukau,1,0,0,1,115,23,0,138
2020-06-27,Hawke's Bay,0,0,0,0,38,6,0,44
2020-06-27,Hutt Valley,0,0,0,0,19,3,0,22
2020-06-27,Lakes,0,0,0,0,15,1,0,16
2020-06-27,Midcentral,0,0,0,0,27,5,0,32
2020-06-27,Nelson Marlborough,0,0,0,0,37,12,0,49
2020-06-27,Northland,0,0,0,0,26,2,0,28
2020-06-27,South Canterbury,0,0,0,0,15,2,0,17
2020-06-27,Southern,0,0,0,0,186,30,2,216
2020-06-27,Tairawhiti,0,0,0,0,3,1,0,4
2020-06-27,Taranaki,0,0,0,0,14,2,0,16
2020-06-27,Waikato,0,0,0,0,153,34,1,187
2020-06-27,Wairarapa,0,0,0,0,6,2,0,8
2020-06-27,Waitemata,0,0,0,0,166,71,4,237
2020-06-27,West Coast,0,0,0,0,4,1,1,5
2020-06-27,Whanganui,0,0,0,0,8,1,0,9
2020-06-26,Auckland,1,0,0,1,134,51,0,185
2020-06-26,Bay of Plenty,0,0,0,0,34,14,0,48
2020-06-26,Canterbury,0,0,0,0,101,65,12,166
2020-06-26,Capital and Coast,0,0,0,0,71,24,2,95
2020-06-26,Counties Manukau,0,0,0,0,114,23,0,137
2020-06-26,Hawke's Bay,0,0,0,0,38,6,0,44
2020-06-26,Hutt Valley,0,0,0,0,19,3,0,22
2020-06-26,Lakes,0,0,0,0,15,1,0,16
2020-06-26,Midcentral,0,0,0,0,27,5,0,32
2020-06-26,Nelson Marlborough,0,0,0,0,37,12,0,49
2020-06-26,Northland,0,0,0,0,26,2,0,28
2020-06-26,South Canterbury,0,0,0,0,15,2,0,17
2020-06-26,Southern,0,0,0,0,186,30,2,216
2020-06-26,Tairawhiti,0,0,0,0,3,1,0,4
2020-06-26,Taranaki,0,0,0,0,14,2,0,16
2020-06-26,Waikato,0,0,0,0,153,34,1,187
2020-06-26,Wairarapa,0,0,0,0,6,2,0,8
2020-06-26,Waitemata,0,0,0,0,166,71,4,237
2020-06-26,West Coast,0,0,0,0,4,1,1,5
2020-06-26,Whanganui,0,0,0,0,8,1,0,9
2020-06-25,Auckland,1,0,0,1,133,51,0,184
2020-06-25,Bay of Plenty,0,0,0,0,34,14,0,48
2020-06-25,Canterbury,0,0,0,0,101,65,12,166
2020-06-25,Capital and Coast,0,0,0,0,71,24,2,95
2020-06-25,Counties Manukau,0,0,0,0,114,23,0,137
2020-06-25,Hawke's Bay,0,0,0,0,38,6,0,44
2020-06-25,Hutt Valley,0,0,0,0,19,3,0,22
2020-06-25,Lakes,0,0,0,0,15,1,0,16
2020-06-25,Midcentral,0,0,0,0,27,5,0,32
2020-06-25,Nelson Marlborough,0,0,0,0,37,12,0,49
2020-06-25,Northland,0,0,0,0,26,2,0,28
2020-06-25,South Canterbury,0,0,0,0,15,2,0,17
2020-06-25,Southern,0,0,0,0,186,30,2,216
2020-06-25,Tairawhiti,0,0,0,0,3,1,0,4
2020-06-25,Taranaki,0,0,0,0,14,2,0,16
2020-06-25,Waikato,0,0,0,0,153,34,1,187
2020-06-25,Wairarapa,0,0,0,0,6,2,0,8
2020-06-25,Waitemata,0,0,0,0,166,71,4,237
2020-06-25,West Coast,0,0,0,0,4,1,1,5
2020-06-25,Whanganui,0,0,0,0,8,1,0,9
2020-06-24,Auckland,0,0,0,0,132,51,0,183
2020-06-24,Bay of Plenty,0,0,0,0,34,14,0,48
2020-06-24,Canterbury,2,0,0,2,101,65,12,166
2020-06-24,Capital and Coast,0,0,0,0,71,24,2,95
2020-06-24,Counties Manukau,1,0,0,1,114,23,0,137
2020-06-24,Hawke's Bay,0,0,0,0,38,6,0,44
2020-06-24,Hutt Valley,0,0,0,0,19,3,0,22
2020-06-24,Lakes,0,0,0,0,15,1,0,16
2020-06-24,Midcentral,0,0,0,0,27,5,0,32
2020-06-24,Nelson Marlborough,0,0,0,0,37,12,0,49
2020-06-24,Northland,0,0,0,0,26,2,0,28
2020-06-24,South Canterbury,0,0,0,0,15,2,0,17
2020-06-24,Southern,0,0,0,0,186,30,2,216
2020-06-24,Tairawhiti,0,0,0,0,3,1,0,4
2020-06-24,Taranaki,0,0,0,0,14,2,0,16
2020-06-24,Waikato,0,0,0,0,153,34,1,187
2020-06-24,Wairarapa,0,0,0,0,6,2,0,8
2020-06-24,Waitemata,0,0,0,0,166,71,4,237
2020-06-24,West Coast,0,0,0,0,4,1,1,5
2020-06-24,Whanganui,0,0,0,0,8,1,0,9
2020-06-23,Auckland,1,0,0,1,132,51,0,183
2020-06-23,Bay of Plenty,0,0,0,0,34,14,0,48
2020-06-23,Canterbury,0,0,0,0,99,65,12,164
2020-06-23,Capital and Coast,0,0,0,0,71,24,2,95
2020-06-23,Counties Manukau,0,0,0,0,113,23,0,136
2020-06-23,Hawke's Bay,0,0,0,0,38,6,0,44
2020-06-23,Hutt Valley,0,0,0,0,19,3,0,22
2020-06-23,Lakes,0,0,0,0,15,1,0,16
2020-06-23,Midcentral,0,0,0,0,27,5,0,32
2020-06-23,Nelson Marlborough,0,0,0,0,37,12,0,49
2020-06-23,Northland,0,0,0,0,26,2,0,28
2020-06-23,South Canterbury,0,0,0,0,15,2,0,17
2020-06-23,Southern,0,0,0,0,186,30,2,216
2020-06-23,Tairawhiti,0,0,0,0,3,1,0,4
2020-06-23,Taranaki,0,0,0,0,14,2,0,16
2020-06-23,Waikato,0,0,0,0,153,34,1,187
2020-06-23,Wairarapa,0,0,0,0,6,2,0,8
2020-06-23,Waitemata,0,0,0,0,166,71,4,237
2020-06-23,West Coast,0,0,0,0,4,1,1,5
2020-06-23,Whanganui,0,0,0,0,8,1,0,9
2020-06-22,Auckland,1,0,0,1,131,51,0,182
2020-06-22,Bay of Plenty,0,0,0,0,34,14,0,48
2020-06-22,Canterbury,0,0,0,0,99,65,12,164
2020-06-22,Capital and Coast,0,0,0,0,71,24,2,95
2020-06-22,Counties Manukau,1,0,0,1,113,23,0,136
2020-06-22,Hawke's Bay,0,0,0,0,38,6,0,44
2020-06-22,Hutt Valley,0,0,0,0,19,3,0,22
2020-06-22,Lakes,0,0,0,0,15,1,0,16
2020-06-22,Midcentral,0,0,0,0,27,5,0,32
2020-06-22,Nelson Marlborough,0,0,0,0,37,12,0,49
2020-06-22,Northland,0,0,0,0,26,2,0,28
2020-06-22,South Canterbury,0,0,0,0,15,2,0,17
2020-06-22,Southern,0,0,0,0,186,30,2,216
2020-06-22,Tairawhiti,0,0,0,0,3,1,0,4
2020-06-22,Taranaki,0,0,0,0,14,2,0,16
2020-06-22,Waikato,0,0,0,0,153,34,1,187
2020-06-22,Wairarapa,0,0,0,0,6,2,0,8
2020-06-22,Waitemata,0,0,0,0,166,71,4,237
2020-06-22,West Coast,0,0,0,0,4,1,1,5
2020-06-22,Whanganui,0,0,0,0,8,1,0,9
2020-06-21,Auckland,2,0,0,2,130,51,0,181
2020-06-21,Bay of Plenty,0,0,0,0,34,14,0,48
2020-06-21,Canterbury,0,0,0,0,99,65,12,164
2020-06-21,Capital and Coast,0,0,0,0,71,24,2,95
2020-06-21,Counties Manukau,1,0,0,1,112,23,0,135
2020-06-21,Hawke's Bay,0,0,0,0,38,6,0,44
2020-06-21,Hutt Valley,0,0,0,0,19,3,0,22
2020-06-21,Lakes,0,0,0,0,15,1,0,16
2020-06-21,Midcentral,0,0,0,0,27,5,0,32
2020-06-21,Nelson Marlborough,0,0,0,0,37,12,0,49
2020-06-21,Northland,0,0,0,0,26,2,0,28
2020-06-21,South Canterbury,0,0,0,0,15,2,0,17
2020-06-21,Southern,0,0,0,0,186,30,2,216
2020-06-21,Tairawhiti,0,0,0,0,3,1,0,4
2020-06-21,Taranaki,0,0,0,0,14,2,0,16
2020-06-21,Waikato,0,0,0,0,153,34,1,187
2020-06-21,Wairarapa,0,0,0,0,6,2,0,8
2020-06-21,Waitemata,0,0,0,0,166,71,4,237
2020-06-21,West Coast,0,0,0,0,4,1,1,5
2020-06-21,Whanganui,0,0,0,0,8,1,0,9
2020-06-20,Auckland,1,0,0,1,128,51,0,179
2020-06-20,Bay of Plenty,0,0,0,0,34,14,0,48
2020-06-20,Canterbury,0,0,0,0,99,65,12,164
2020-06-20,Capital and Coast,0,0,0,0,71,24,2,95
2020-06-20,Counties Manukau,0,0,0,0,111,23,0,134
2020-06-20,Hawke's Bay,0,0,0,0,38,6,0,44
2020-06-20,Hutt Valley,0,0,0,0,19,3,0,22
2020-06-20,Lakes,0,0,0,0,15,1,0,16
2020-06-20,Midcentral,0,0,0,0,27,5,0,32
2020-06-20,Nelson Marlborough,0,0,0,0,37,12,0,49
2020-06-20,Northland,0,0,0,0,26,2,0,28
2020-06-20,South Canterbury,0,0,0,0,15,2,0,17
2020-06-20,Southern,0,0,0,0,186,30,2,216
2020-06-20,Tairawhiti,0,0,0,0,3,1,0,4
2020-06-20,Taranaki,0,0,0,0,14,2,0,16
2020-06-20,Waikato,0,0,0,0,153,34,1,187
2020-06-20,Wairarapa,0,0,0,0,6,2,0,8
2020-06-20,Waitemata,0,0,0,0,166,71,4,237
2020-06-20,West Coast,0,0,0,0,4,1,1,5
2020-06-20,Whanganui,0,0,0,0,8,1,0,9
2020-06-19,Auckland,2,0,0,2,127,51,0,178
2020-06-19,Bay of Plenty,0,0,0,0,34,14,0,48
2020-06-19,Canterbury,0,0,0,0,99,65,12,164
2020-06-19,Capital and Coast,0,0,0,0,71,24,2,95
2020-06-19,Counties Manukau,0,0,0,0,111,23,0,134
2020-06-19,Hawke's Bay,0,0,0,0,38,6,0,44
2020-06-19,Hutt Valley,0,0,0,0,19,3,0,22
2020-06-19,Lakes,0,0,0,0,15,1,0,16
2020-06-19,Midcentral,0,0,0,0,27,5,0,32
2020-06-19,Nelson Marlborough,0,0,0,0,37,12,0,49
2020-06-19,Northland,0,0,0,0,26,2,0,28
2020-06-19,South Canterbury,0,0,0,0,15,2,0,17
2020-06-19,Southern,0,0,0,0,186,30,2,216
2020-06-19,Tairawhiti,0,0,0,0,3,1,0,4
2020-06-19,Taranaki,0,0,0,0,14,2,0,16
2020-06-19,Waikato,0,0,0,0,153,34,1,187
2020-06-19,Wairarapa,0,0,0,0,6,2,0,8
2020-06-19,Waitemata,0,0,0,0,166,71,4,237
2020-06-19,West Coast,0,0,0,0,4,1,1,5
2020-06-19,Whanganui,0,0,0,0,8,1,0,9
2020-06-18,Auckland,0,0,0,0,125,51,0,176
2020-06-18,Bay of Plenty,0,0,0,0,34,14,0,48
2020-06-18,Canterbury,0,0,0,0,99,65,12,164
2020-06-18,Capital and Coast,0,0,0,0,71,24,2,95
2020-06-18,Counties Manukau,0,0,0,0,111,23,0,134
2020-06-18,Hawke's Bay,0,0,0,0,38,6,0,44
2020-06-18,Hutt Valley,0,0,0,0,19,3,0,22
2020-06-18,Lakes,0,0,0,0,15,1,0,16
2020-06-18,Midcentral,0,0,0,0,27,5,0,32
2020-06-18,Nelson Marlborough,0,0,0,0,37,12,0,49
2020-06-18,Northland,0,0,0,0,26,2,0,28
2020-06-18,South Canterbury,0,0,0,0,15,2,0,17
2020-06-18,Southern,0,0,0,0,186,30,2,216
2020-06-18,Tairawhiti,0,0,0,0,3,1,0,4
2020-06-18,Taranaki,0,0,0,0,14,2,0,16
2020-06-18,Waikato,0,0,0,0,153,34,1,187
2020-06-18,Wairarapa,0,0,0,0,6,2,0,8
2020-06-18,Waitemata,0,0,0,0,166,71,4,237
2020-06-18,West Coast,0,0,0,0,4,1,1,5
2020-06-18,Whanganui,0,0,0,0,8,1,0,9
2020-06-17,Auckland,0,0,0,0,125,51,0,176
2020-06-17,Bay of Plenty,0,0,0,0,34,14,0,48
2020-06-17,Canterbury,0,0,0,0,99,65,12,164
2020-06-17,Capital and Coast,0,0,0,0,71,24,2,95
2020-06-17,Counties Manukau,1,0,0,1,111,23,0,134
2020-06-17,Hawke's Bay,0,0,0,0,38,6,0,44
2020-06-17,Hutt Valley,0,0,0,0,19,3,0,22
2020-06-17,Lakes,0,0,0,0,15,1,0,16
2020-06-17,Midcentral,0,0,0,0,27,5,0,32
2020-06-17,Nelson Marlborough,0,0,0,0,37,12,0,49
2020-06-17,Northland,0,0,0,0,26,2,0,28
2020-06-17,South Canterbury,0,0,0,0,15,2,0,17
2020-06-17,Southern,0,0,0,0,186,30,2,216
2020-06-17,Tairawhiti,0,0,0,0,3,1,0,4
2020-06-17,Taranaki,0,0,0,0,14,2,0,16
2020-06-17,Waikato,0,0,0,0,153,34,1,187
2020-06-17,Wairarapa,0,0,0,0,6,2,0,8
2020-06-17,Waitemata,0,0,0,0,166,71,4,237
2020-06-17,West Coast,0,0,0,0,4,1,1,5
2020-06-17,Whanganui,0,0,0,0,8,1,0,9
2020-06-16,Auckland,0,0,0,0,125,51,0,176
2020-06-16,Bay of Plenty,0,0,0,0,34,14,0,48
2020-06-16,Canterbury,0,0,0,0,99,65,12,164
2020-06-16,Capital and Coast,0,0,0,0,71,24,2,95
2020-06-16,Counties Manukau,0,0,0,0,110,23,0,133
2020-06-16,Hawke's Bay,0,0,0,0,38,6,0,44
2020-06-16,Hutt Valley,2,0,0,2,19,3,0,22
2020-06-16,Lakes,0,0,0,0,15,1,0,16
2020-06-16,Midcentral,0,0,0,0,27,5,0,32
2020-06-16,Nelson Marlborough,0,0,0,0,37,12,0,49
2020-06-16,Northland,0,0,0,0,26,2,0,28
2020-06-16,South Canterbury,0,0,0,0,15,2,0,17
2020-06-16,Southern,0,0,0,0,186,30,2,216
2020-06-16,Tairawhiti,0,0,0,0,3,1,0,4
2020-06-16,Taranaki,0,0,0,0,14,2,0,16
2020-06-16,Waikato,0,0,0,0,153,34,1,187
2020-06-16,Wairarapa,0,0,0,0,6,2,0,8
2020-06-16,Waitemata,0,0,0,0,166,71,4,237
2020-06-16,West Coast,0,0,0,0,4,1,1,5
2020-06-16,Whanganui,0,0,0,0,8,1,0,9
2020-06-15,Auckland,0,0,0,0,125,51,0,176
2020-06-15,Bay of Plenty,0,0,0,0,34,14,0,48
2020-06-15,Canterbury,0,0,0,0,99,65,12,164
2020-06-15,Capital and Coast,0,0,0,0,71,24,2,95
2020-06-15,Counties Manukau,0,0,0,0,110,23,0,133
2020-06-15,Hawke's Bay,0,0,0,0,38,6,0,44
2020-06-15,Hutt Valley,0,0,0,0,17,3,0,20
2020-06-15,Lakes,0,0,0,0,15,1,0,16
2020-06-15,Midcentral,0,0,0,0,27,5,0,32
2020-06-15,Nelson Marlborough,0,0,0,0,37,12,0,49
2020-06-15,Northland,0,0,0,0,26,2,0,28
2020-06-15,South Canterbury,0,0,0,0,15,2,0,17
2020-06-15,Southern,0,0,0,0,186,30,2,216
2020-06-15,Tairawhiti,0,0,0,0,3,1,0,4
2020-06-15,Taranaki,0,0,0,0,14,2,0,16
2020-06-15,Waikato,0,0,0,0,153,34,1,187
2020-06-15,Wairarapa,0,0,0,0,6,2,0,8
2020-06-15,Waitemata,0,0,0,0,166,71,4,237
2020-06-15,West Coast,0,0,0,0,4,1,1,5
2020-06-15,Whanganui,0,0,0,0,8,1,0,9
2020-06-14,Auckland,0,0,0,0,125,51,0,176
2020-06-14,Bay of Plenty,0,0,0,0,34,14,0,48
2020-06-14,Canterbury,0,0,0,0,99,65,12,164
2020-06-14,Capital and Coast,0,0,0,0,71,24,2,95
2020-06-14,Counties Manukau,0,0,0,0,110,23,0,133
2020-06-14,Hawke's Bay,0,0,0,0,38,6,0,44
2020-06-14,Hutt Valley,0,0,0,0,17,3,0,20
2020-06-14,Lakes,0,0,0,0,15,1,0,16
2020-06-14,Midcentral,0,0,0,0,27,5,0,32
2020-06-14,Nelson Marlborough,0,0,0,0,37,12,0,49
2020-06-14,Northland,0,0,0,0,26,2,0,28
2020-06-14,South Canterbury,0,0,0,0,15,2,0,17
2020-06-14,Southern,0,0,0,0,186,30,2,216
2020-06-14,Tairawhiti,0,0,0,0,3,1,0,4
2020-06-14,Taranaki,0,0,0,0,14,2,0,16
2020-06-14,Waikato,0,0,0,0,153,34,1,187
2020-06-14,Wairarapa,0,0,0,0,6,2,0,8
2020-06-14,Waitemata,0,0,0,0,166,71,4,237
2020-06-14,West Coast,0,0,0,0,4,1,1,5
2020-06-14,Whanganui,0,0,0,0,8,1,0,9
2020-06-13,Auckland,0,0,0,0,125,51,0,176
2020-06-13,Bay of Plenty,0,0,0,0,34,14,0,48
2020-06-13,Canterbury,0,0,0,0,99,65,12,164
2020-06-13,Capital and Coast,0,0,0,0,71,24,2,95
2020-06-13,Counties Manukau,0,0,0,0,110,23,0,133
2020-06-13,Hawke's Bay,0,0,0,0,38,6,0,44
2020-06-13,Hutt Valley,0,0,0,0,17,3,0,20
2020-06-13,Lakes,0,0,0,0,15,1,0,16
2020-06-13,Midcentral,0,0,0,0,27,5,0,32
2020-06-13,Nelson Marlborough,0,0,0,0,37,12,0,49
2020-06-13,Northland,0,0,0,0,26,2,0,28
2020-06-13,South Canterbury,0,0,0,0,15,2,0,17
2020-06-13,Southern,0,0,0,0,186,30,2,216
2020-06-13,Tairawhiti,0,0,0,0,3,1,0,4
2020-06-13,Taranaki,0,0,0,0,14,2,0,16
2020-06-13,Waikato,0,0,0,0,153,34,1,187
2020-06-13,Wairarapa,0,0,0,0,6,2,0,8
2020-06-13,Waitemata,0,0,0,0,166,71,4,237
2020-06-13,West Coast,0,0,0,0,4,1,1,5
2020-06-13,Whanganui,0,0,0,0,8,1,0,9
2020-06-12,Auckland,0,0,0,0,125,51,0,176
2020-06-12,Bay of Plenty,0,0,0,0,34,14,0,48
2020-06-12,Canterbury,0,0,0,0,99,65,12,164
2020-06-12,Capital and Coast,0,0,0,0,71,24,2,95
2020-06-12,Counties Manukau,0,0,0,0,110,23,0,133
2020-06-12,Hawke's Bay,0,0,0,0,38,6,0,44
2020-06-12,Hutt Valley,0,0,0,0,17,3,0,20
2020-06-12,Lakes,0,0,0,0,15,1,0,16
2020-06-12,Midcentral,0,0,0,0,27,5,0,32
2020-06-12,Nelson Marlborough,0,0,0,0,37,12,0,49
2020-06-12,Northland,0,0,0,0,26,2,0,28
2020-06-12,South Canterbury,0,0,0,0,15,2,0,17
2020-06-12,Southern,0,0,0,0,186,30,2,216
2020-06-12,Tairawhiti,0,0,0,0,3,1,0,4
2020-06-12,Taranaki,0,0,0,0,14,2,0,16
2020-06-12,Waikato,0,0,0,0,153,34,1,187
2020-06-12,Wairarapa,0,0,0,0,6,2,0,8
2020-06-12,Waitemata,0,0,0,0,166,71,4,237
2020-06-12,West Coast,0,0,0,0,4,1,1,5
2020-06-12,Whanganui,0,0,0,0,8,1,0,9
2020-06-11,Auckland,0,0,0,0,125,51,0,176
2020-06-11,Bay of Plenty,0,0,0,0,34,14,0,48
2020-06-11,Canterbury,0,0,0,0,99,65,12,164
2020-06-11,Capital and Coast,0,0,0,0,71,24,2,95
2020-06-11,Counties Manukau,0,0,0,0,110,23,0,133
2020-06-11,Hawke's Bay,0,0,0,0,38,6,0,44
2020-06-11,Hutt Valley,0,0,0,0,17,3,0,20
2020-06-11,Lakes,0,0,0,0,15,1,0,16
2020-06-11,Midcentral,0,0,0,0,27,5,0,32
2020-06-11,Nelson Marlborough,0,0,0,0,37,12,0,49
2020-06-11,Northland,0,0,0,0,26,2,0,28
2020-06-11,South Canterbury,0,0,0,0,15,2,0,17
2020-06-11,Southern,0,0,0,0,186,30,2,216
2020-06-11,Tairawhiti,0,0,0,0,3,1,0,4
2020-06-11,Taranaki,0,0,0,0,14,2,0,16
2020-06-11,Waikato,0,0,0,0,153,34,1,187
2020-06-11,Wairarapa,0,0,0,0,6,2,0,8
2020-06-11,Waitemata,0,0,0,0,166,71,4,237
2020-06-11,West Coast,0,0,0,0,4,1,1,5
2020-06-11,Whanganui,0,0,0,0,8,1,0,9
2020-06-10,Auckland,0,0,0,0,125,51,0,176
2020-06-10,Bay of Plenty,0,0,0,0,34,14,0,48
2020-06-10,Canterbury,0,0,0,0,99,65,12,164
2020-06-10,Capital and Coast,0,0,0,0,71,24,2,95
2020-06-10,Counties Manukau,0,0,0,0,110,23,0,133
2020-06-10,Hawke's Bay,0,0,0,0,38,6,0,44
2020-06-10,Hutt Valley,0,0,0,0,17,3,0,20
2020-06-10,Lakes,0,0,0,0,15,1,0,16
2020-06-10,Midcentral,0,0,0,0,27,5,0,32
2020-06-10,Nelson Marlborough,0,0,0,0,37,12,0,49
2020-06-10,Northland,0,0,0,0,26,2,0,28
2020-06-10,South Canterbury,0,0,0,0,15,2,0,17
2020-06-10,Southern,0,0,0,0,186,30,2,216
2020-06-10,Tairawhiti,0,0,0,0,3,1,0,4
2020-06-10,Taranaki,0,0,0,0,14,2,0,16
2020-06-10,Waikato,0,0,0,0,153,34,1,187
2020-06-10,Wairarapa,0,0,0,0,6,2,0,8
2020-06-10,Waitemata,0,0,0,0,166,71,4,237
2020-06-10,West Coast,0,0,0,0,4,1,1,5
2020-06-10,Whanganui,0,0,0,0,8,1,0,9
2020-06-09,Auckland,0,0,0,0,125,51,0,176
2020-06-09,Bay of Plenty,0,0,0,0,34,14,0,48
2020-06-09,Canterbury,0,0,0,0,99,65,12,164
2020-06-09,Capital and Coast,0,0,0,0,71,24,2,95
2020-06-09,Counties Manukau,0,0,0,0,110,23,0,133
2020-06-09,Hawke's Bay,0,0,0,0,38,6,0,44
2020-06-09,Hutt Valley,0,0,0,0,17,3,0,20
2020-06-09,Lakes,0,0,0,0,15,1,0,16
2020-06-09,Midcentral,0,0,0,0,27,5,0,32
2020-06-09,Nelson Marlborough,0,0,0,0,37,12,0,49
2020-06-09,Northland,0,0,0,0,26,2,0,28
2020-06-09,South Canterbury,0,0,0,0,15,2,0,17
2020-06-09,Southern,0,0,0,0,186,30,2,216
2020-06-09,Tairawhiti,0,0,0,0,3,1,0,4
2020-06-09,Taranaki,0,0,0,0,14,2,0,16
2020-06-09,Waikato,0,0,0,0,153,34,1,187
2020-06-09,Wairarapa,0,0,0,0,6,2,0,8
2020-06-09,Waitemata,0,0,0,0,166,71,4,237
2020-06-09,West Coast,0,0,0,0,4,1,1,5
2020-06-09,Whanganui,0,0,0,0,8,1,0,9
2020-06-08,Auckland,0,0,0,0,125,51,0,176
2020-06-08,Bay of Plenty,0,0,0,0,34,14,0,48
2020-06-08,Canterbury,0,0,0,0,99,65,12,164
2020-06-08,Capital and Coast,0,0,0,0,71,24,2,95
2020-06-08,Counties Manukau,0,0,0,0,110,23,0,133
2020-06-08,Hawke's Bay,0,0,0,0,38,6,0,44
2020-06-08,Hutt Valley,0,0,0,0,17,3,0,20
2020-06-08,Lakes,0,0,0,0,15,1,0,16
2020-06-08,Midcentral,0,0,0,0,27,5,0,32
2020-06-08,Nelson Marlborough,0,0,0,0,37,12,0,49
2020-06-08,Northland,0,0,0,0,26,2,0,28
2020-06-08,South Canterbury,0,0,0,0,15,2,0,17
2020-06-08,Southern,0,0,0,0,186,30,2,216
2020-06-08,Tairawhiti,0,0,0,0,3,1,0,4
2020-06-08,Taranaki,0,0,0,0,14,2,0,16
2020-06-08,Waikato,0,0,0,0,153,34,1,187
2020-06-08,Wairarapa,0,0,0,0,6,2,0,8
2020-06-08,Waitemata,0,0,0,0,166,71,4,237
2020-06-08,West Coast,0,0,0,0,4,1,1,5
2020-06-08,Whanganui,0,0,0,0,8,1,0,9
2020-06-07,Auckland,0,0,0,0,125,51,0,176
2020-06-07,Bay of Plenty,0,0,0,0,34,14,0,48
2020-06-07,Canterbury,0,0,0,0,99,65,12,164
2020-06-07,Capital and Coast,0,0,0,0,71,24,2,95
2020-06-07,Counties Manukau,0,0,0,0,110,23,0,133
2020-06-07,Hawke's Bay,0,0,0,0,38,6,0,44
2020-06-07,Hutt Valley,0,0,0,0,17,3,0,20
2020-06-07,Lakes,0,0,0,0,15,1,0,16
2020-06-07,Midcentral,0,0,0,0,27,5,0,32
2020-06-07,Nelson Marlborough,0,0,0,0,37,12,0,49
2020-06-07,Northland,0,0,0,0,26,2,0,28
2020-06-07,South Canterbury,0,0,0,0,15,2,0,17
2020-06-07,Southern,0,0,0,0,186,30,2,216
2020-06-07,Tairawhiti,0,0,0,0,3,1,0,4
2020-06-07,Taranaki,0,0,0,0,14,2,0,16
2020-06-07,Waikato,0,0,0,0,153,34,1,187
2020-06-07,Wairarapa,0,0,0,0,6,2,0,8
2020-06-07,Waitemata,0,0,0,0,166,71,4,237
2020-06-07,West Coast,0,0,0,0,4,1,1,5
2020-06-07,Whanganui,0,0,0,0,8,1,0,9
2020-06-06,Auckland,0,0,0,0,125,51,0,176
2020-06-06,Bay of Plenty,0,0,0,0,34,14,0,48
2020-06-06,Canterbury,0,0,0,0,99,65,12,164
2020-06-06,Capital and Coast,0,0,0,0,71,24,2,95
2020-06-06,Counties Manukau,0,0,0,0,110,23,0,133
2020-06-06,Hawke's Bay,0,0,0,0,38,6,0,44
2020-06-06,Hutt Valley,0,0,0,0,17,3,0,20
2020-06-06,Lakes,0,0,0,0,15,1,0,16
2020-06-06,Midcentral,0,0,0,0,27,5,0,32
2020-06-06,Nelson Marlborough,0,0,0,0,37,12,0,49
2020-06-06,Northland,0,0,0,0,26,2,0,28
2020-06-06,South Canterbury,0,0,0,0,15,2,0,17
2020-06-06,Southern,0,0,0,0,186,30,2,216
2020-06-06,Tairawhiti,0,0,0,0,3,1,0,4
2020-06-06,Taranaki,0,0,0,0,14,2,0,16
2020-06-06,Waikato,0,0,0,0,153,34,1,187
2020-06-06,Wairarapa,0,0,0,0,6,2,0,8
2020-06-06,Waitemata,0,0,0,0,166,71,4,237
2020-06-06,West Coast,0,0,0,0,4,1,1,5
2020-06-06,Whanganui,0,0,0,0,8,1,0,9
2020-06-05,Auckland,0,0,0,0,125,51,0,176
2020-06-05,Bay of Plenty,0,0,0,0,34,14,0,48
2020-06-05,Canterbury,0,0,0,0,99,65,12,164
2020-06-05,Capital and Coast,0,0,0,0,71,24,2,95
2020-06-05,Counties Manukau,0,0,0,0,110,23,0,133
2020-06-05,Hawke's Bay,0,0,0,0,38,6,0,44
2020-06-05,Hutt Valley,0,0,0,0,17,3,0,20
2020-06-05,Lakes,0,0,0,0,15,1,0,16
2020-06-05,Midcentral,0,0,0,0,27,5,0,32
2020-06-05,Nelson Marlborough,0,0,0,0,37,12,0,49
2020-06-05,Northland,0,0,0,0,26,2,0,28
2020-06-05,South Canterbury,0,0,0,0,15,2,0,17
2020-06-05,Southern,0,0,0,0,186,30,2,216
2020-06-05,Tairawhiti,0,0,0,0,3,1,0,4
2020-06-05,Taranaki,0,0,0,0,14,2,0,16
2020-06-05,Waikato,0,0,0,0,153,34,1,187
2020-06-05,Wairarapa,0,0,0,0,6,2,0,8
2020-06-05,Waitemata,0,0,0,0,166,71,4,237
2020-06-05,West Coast,0,0,0,0,4,1,1,5
2020-06-05,Whanganui,0,0,0,0,8,1,0,9
2020-06-04,Auckland,0,0,0,0,125,51,0,176
2020-06-04,Bay of Plenty,0,0,0,0,34,14,0,48
2020-06-04,Canterbury,0,0,0,0,99,65,12,164
2020-06-04,Capital and Coast,0,0,0,0,71,24,2,95
2020-06-04,Counties Manukau,0,0,0,0,110,23,0,133
2020-06-04,Hawke's Bay,0,0,0,0,38,6,0,44
2020-06-04,Hutt Valley,0,0,0,0,17,3,0,20
2020-06-04,Lakes,0,0,0,0,15,1,0,16
2020-06-04,Midcentral,0,0,0,0,27,5,0,32
2020-06-04,Nelson Marlborough,0,0,0,0,37,12,0,49
2020-06-04,Northland,0,0,0,0,26,2,0,28
2020-06-04,South Canterbury,0,0,0,0,15,2,0,17
2020-06-04,Southern,0,0,0,0,186,30,2,216
2020-06-04,Tairawhiti,0,0,0,0,3,1,0,4
2020-06-04,Taranaki,0,0,0,0,14,2,0,16
2020-06-04,Waikato,0,0,0,0,153,34,1,187
2020-06-04,Wairarapa,0,0,0,0,6,2,0,8
2020-06-04,Waitemata,0,0,0,0,166,71,4,237
2020-06-04,West Coast,0,0,0,0,4,1,1,5
2020-06-04,Whanganui,0,0,0,0,8,1,0,9
2020-06-03,Auckland,0,0,0,0,125,51,0,176
2020-06-03,Bay of Plenty,0,0,0,0,34,14,0,48
2020-06-03,Canterbury,0,0,0,0,99,65,12,164
2020-06-03,Capital and Coast,0,0,0,0,71,24,2,95
2020-06-03,Counties Manukau,0,0,0,0,110,23,0,133
2020-06-03,Hawke's Bay,0,0,0,0,38,6,0,44
2020-06-03,Hutt Valley,0,0,0,0,17,3,0,20
2020-06-03,Lakes,0,0,0,0,15,1,0,16
2020-06-03,Midcentral,0,0,0,0,27,5,0,32
2020-06-03,Nelson Marlborough,0,0,0,0,37,12,0,49
2020-06-03,Northland,0,0,0,0,26,2,0,28
2020-06-03,South Canterbury,0,0,0,0,15,2,0,17
2020-06-03,Southern,0,0,0,0,186,30,2,216
2020-06-03,Tairawhiti,0,0,0,0,3,1,0,4
2020-06-03,Taranaki,0,0,0,0,14,2,0,16
2020-06-03,Waikato,0,0,0,0,153,34,1,187
2020-06-03,Wairarapa,0,0,0,0,6,2,0,8
2020-06-03,Waitemata,0,0,0,0,166,71,4,237
2020-06-03,West Coast,0,0,0,0,4,1,1,5
2020-06-03,Whanganui,0,0,0,0,8,1,0,9
2020-06-02,Auckland,0,0,0,0,125,51,0,176
2020-06-02,Bay of Plenty,0,0,0,0,34,14,0,48
2020-06-02,Canterbury,0,0,0,0,99,65,12,164
2020-06-02,Capital and Coast,0,0,0,0,71,24,2,95
2020-06-02,Counties Manukau,0,0,0,0,110,23,0,133
2020-06-02,Hawke's Bay,0,0,0,0,38,6,0,44
2020-06-02,Hutt Valley,0,0,0,0,17,3,0,20
2020-06-02,Lakes,0,0,0,0,15,1,0,16
2020-06-02,Midcentral,0,0,0,0,27,5,0,32
2020-06-02,Nelson Marlborough,0,0,0,0,37,12,0,49
2020-06-02,Northland,0,0,0,0,26,2,0,28
2020-06-02,South Canterbury,0,0,0,0,15,2,0,17
2020-06-02,Southern,0,0,0,0,186,30,2,216
2020-06-02,Tairawhiti,0,0,0,0,3,1,0,4
2020-06-02,Taranaki,0,0,0,0,14,2,0,16
2020-06-02,Waikato,0,0,0,0,153,34,1,187
2020-06-02,Wairarapa,0,0,0,0,6,2,0,8
2020-06-02,Waitemata,0,0,0,0,166,71,4,237
2020-06-02,West Coast,0,0,0,0,4,1,1,5
2020-06-02,Whanganui,0,0,0,0,8,1,0,9
2020-06-01,Auckland,0,0,0,0,125,51,0,176
2020-06-01,Bay of Plenty,0,0,0,0,34,14,0,48
2020-06-01,Canterbury,0,0,0,0,99,65,12,164
2020-06-01,Capital and Coast,0,0,0,0,71,24,2,95
2020-06-01,Counties Manukau,0,0,0,0,110,23,0,133
2020-06-01,Hawke's Bay,0,0,0,0,38,6,0,44
2020-06-01,Hutt Valley,0,0,0,0,17,3,0,20
2020-06-01,Lakes,0,0,0,0,15,1,0,16
2020-06-01,Midcentral,0,0,0,0,27,5,0,32
2020-06-01,Nelson Marlborough,0,0,0,0,37,12,0,49
2020-06-01,Northland,0,0,0,0,26,2,0,28
2020-06-01,South Canterbury,0,0,0,0,15,2,0,17
2020-06-01,Southern,0,0,0,0,186,30,2,216
2020-06-01,Tairawhiti,0,0,0,0,3,1,0,4
2020-06-01,Taranaki,0,0,0,0,14,2,0,16
2020-06-01,Waikato,0,0,0,0,153,34,1,187
2020-06-01,Wairarapa,0,0,0,0,6,2,0,8
2020-06-01,Waitemata,0,0,0,0,166,71,4,237
2020-06-01,West Coast,0,0,0,0,4,1,1,5
2020-06-01,Whanganui,0,0,0,0,8,1,0,9
2020-05-31,Auckland,0,0,0,0,125,51,0,176
2020-05-31,Bay of Plenty,0,0,0,0,34,14,0,48
2020-05-31,Canterbury,0,0,0,0,99,65,12,164
2020-05-31,Capital and Coast,0,0,0,0,71,24,2,95
2020-05-31,Counties Manukau,0,0,0,0,110,23,0,133
2020-05-31,Hawke's Bay,0,0,0,0,38,6,0,44
2020-05-31,Hutt Valley,0,0,0,0,17,3,0,20
2020-05-31,Lakes,0,0,0,0,15,1,0,16
2020-05-31,Midcentral,0,0,0,0,27,5,0,32
2020-05-31,Nelson Marlborough,0,0,0,0,37,12,0,49
2020-05-31,Northland,0,0,0,0,26,2,0,28
2020-05-31,South Canterbury,0,0,0,0,15,2,0,17
2020-05-31,Southern,0,0,0,0,186,30,2,216
2020-05-31,Tairawhiti,0,0,0,0,3,1,0,4
2020-05-31,Taranaki,0,0,0,0,14,2,0,16
2020-05-31,Waikato,0,0,0,0,153,34,1,187
2020-05-31,Wairarapa,0,0,0,0,6,2,0,8
2020-05-31,Waitemata,0,0,0,0,166,71,4,237
2020-05-31,West Coast,0,0,0,0,4,1,1,5
2020-05-31,Whanganui,0,0,0,0,8,1,0,9
2020-05-30,Auckland,0,0,0,0,125,51,0,176
2020-05-30,Bay of Plenty,0,0,0,0,34,14,0,48
2020-05-30,Canterbury,0,0,0,0,99,65,12,164
2020-05-30,Capital and Coast,0,0,0,0,71,24,2,95
2020-05-30,Counties Manukau,0,0,0,0,110,23,0,133
2020-05-30,Hawke's Bay,0,0,0,0,38,6,0,44
2020-05-30,Hutt Valley,0,0,0,0,17,3,0,20
2020-05-30,Lakes,0,0,0,0,15,1,0,16
2020-05-30,Midcentral,0,0,0,0,27,5,0,32
2020-05-30,Nelson Marlborough,0,0,0,0,37,12,0,49
2020-05-30,Northland,0,0,0,0,26,2,0,28
2020-05-30,South Canterbury,0,0,0,0,15,2,0,17
2020-05-30,Southern,0,0,0,0,186,30,2,216
2020-05-30,Tairawhiti,0,0,0,0,3,1,0,4
2020-05-30,Taranaki,0,0,0,0,14,2,0,16
2020-05-30,Waikato,0,0,0,0,153,34,1,187
2020-05-30,Wairarapa,0,0,0,0,6,2,0,8
2020-05-30,Waitemata,0,0,0,0,166,71,4,237
2020-05-30,West Coast,0,0,0,0,4,1,1,5
2020-05-30,Whanganui,0,0,0,0,8,1,0,9
2020-05-29,Auckland,0,0,0,0,125,51,0,176
2020-05-29,Bay of Plenty,0,0,0,0,34,14,0,48
2020-05-29,Canterbury,0,0,0,0,99,65,12,164
2020-05-29,Capital and Coast,0,0,0,0,71,24,2,95
2020-05-29,Counties Manukau,0,0,0,0,110,23,0,133
2020-05-29,Hawke's Bay,0,0,0,0,38,6,0,44
2020-05-29,Hutt Valley,0,0,0,0,17,3,0,20
2020-05-29,Lakes,0,0,0,0,15,1,0,16
2020-05-29,Midcentral,0,0,0,0,27,5,0,32
2020-05-29,Nelson Marlborough,0,0,0,0,37,12,0,49
2020-05-29,Northland,0,0,0,0,26,2,0,28
2020-05-29,South Canterbury,0,0,0,0,15,2,0,17
2020-05-29,Southern,0,0,0,0,186,30,2,216
2020-05-29,Tairawhiti,0,0,0,0,3,1,0,4
2020-05-29,Taranaki,0,0,0,0,14,2,0,16
2020-05-29,Waikato,0,0,0,0,153,34,1,187
2020-05-29,Wairarapa,0,0,0,0,6,2,0,8
2020-05-29,Waitemata,0,0,0,0,166,71,4,237
2020-05-29,West Coast,0,0,0,0,4,1,1,5
2020-05-29,Whanganui,0,0,0,0,8,1,0,9
2020-05-28,Auckland,0,0,0,0,125,51,0,176
2020-05-28,Bay of Plenty,0,0,0,0,34,14,0,48
2020-05-28,Canterbury,0,0,0,0,99,65,12,164
2020-05-28,Capital and Coast,0,0,0,0,71,24,2,95
2020-05-28,Counties Manukau,0,0,0,0,110,23,0,133
2020-05-28,Hawke's Bay,0,0,0,0,38,6,0,44
2020-05-28,Hutt Valley,0,0,0,0,17,3,0,20
2020-05-28,Lakes,0,0,0,0,15,1,0,16
2020-05-28,Midcentral,0,0,0,0,27,5,0,32
2020-05-28,Nelson Marlborough,0,0,0,0,37,12,0,49
2020-05-28,Northland,0,0,0,0,26,2,0,28
2020-05-28,South Canterbury,0,0,0,0,15,2,0,17
2020-05-28,Southern,0,0,0,0,186,30,2,216
2020-05-28,Tairawhiti,0,0,0,0,3,1,0,4
2020-05-28,Taranaki,0,0,0,0,14,2,0,16
2020-05-28,Waikato,0,0,0,0,153,34,1,187
2020-05-28,Wairarapa,0,0,0,0,6,2,0,8
2020-05-28,Waitemata,0,0,0,0,166,71,4,237
2020-05-28,West Coast,0,0,0,0,4,1,1,5
2020-05-28,Whanganui,0,0,0,0,8,1,0,9
2020-05-27,Auckland,0,0,0,0,125,51,0,176
2020-05-27,Bay of Plenty,0,0,0,0,34,14,0,48
2020-05-27,Canterbury,0,0,0,0,99,65,12,164
2020-05-27,Capital and Coast,0,0,0,0,71,24,2,95
2020-05-27,Counties Manukau,0,0,0,0,110,23,0,133
2020-05-27,Hawke's Bay,0,0,0,0,38,6,0,44
2020-05-27,Hutt Valley,0,0,0,0,17,3,0,20
2020-05-27,Lakes,0,0,0,0,15,1,0,16
2020-05-27,Midcentral,0,0,0,0,27,5,0,32
2020-05-27,Nelson Marlborough,0,0,0,0,37,12,0,49
2020-05-27,Northland,0,0,0,0,26,2,0,28
2020-05-27,South Canterbury,0,0,0,0,15,2,0,17
2020-05-27,Southern,0,0,0,0,186,30,2,216
2020-05-27,Tairawhiti,0,0,0,0,3,1,0,4
2020-05-27,Taranaki,0,0,0,0,14,2,0,16
2020-05-27,Waikato,0,0,0,0,153,34,1,187
2020-05-27,Wairarapa,0,0,0,0,6,2,0,8
2020-05-27,Waitemata,0,0,0,0,166,71,4,237
2020-05-27,West Coast,0,0,0,0,4,1,1,5
2020-05-27,Whanganui,0,0,0,0,8,1,0,9
2020-05-26,Auckland,0,0,0,0,125,51,0,176
2020-05-26,Bay of Plenty,0,0,0,0,34,14,0,48
2020-05-26,Canterbury,0,0,0,0,99,65,12,164
2020-05-26,Capital and Coast,0,0,0,0,71,24,2,95
2020-05-26,Counties Manukau,0,0,0,0,110,23,0,133
2020-05-26,Hawke's Bay,0,0,0,0,38,6,0,44
2020-05-26,Hutt Valley,0,0,0,0,17,3,0,20
2020-05-26,Lakes,0,0,0,0,15,1,0,16
2020-05-26,Midcentral,0,0,0,0,27,5,0,32
2020-05-26,Nelson Marlborough,0,0,0,0,37,12,0,49
2020-05-26,Northland,0,0,0,0,26,2,0,28
2020-05-26,South Canterbury,0,0,0,0,15,2,0,17
2020-05-26,Southern,0,0,0,0,186,30,2,216
2020-05-26,Tairawhiti,0,0,0,0,3,1,0,4
2020-05-26,Taranaki,0,0,0,0,14,2,0,16
2020-05-26,Waikato,0,0,0,0,153,34,1,187
2020-05-26,Wairarapa,0,0,0,0,6,2,0,8
2020-05-26,Waitemata,0,0,0,0,166,71,4,237
2020-05-26,West Coast,0,0,0,0,4,1,1,5
2020-05-26,Whanganui,0,0,0,0,8,1,0,9
2020-05-25,Auckland,0,0,0,0,125,51,0,176
2020-05-25,Bay of Plenty,0,0,0,0,34,14,0,48
2020-05-25,Canterbury,0,0,0,0,99,65,12,164
2020-05-25,Capital and Coast,0,0,0,0,71,24,2,95
2020-05-25,Counties Manukau,0,0,0,0,110,23,0,133
2020-05-25,Hawke's Bay,0,0,0,0,38,6,0,44
2020-05-25,Hutt Valley,0,0,0,0,17,3,0,20
2020-05-25,Lakes,0,0,0,0,15,1,0,16
2020-05-25,Midcentral,0,0,0,0,27,5,0,32
2020-05-25,Nelson Marlborough,0,0,0,0,37,12,0,49
2020-05-25,Northland,0,0,0,0,26,2,0,28
2020-05-25,South Canterbury,0,0,0,0,15,2,0,17
2020-05-25,Southern,0,0,0,0,186,30,2,216
2020-05-25,Tairawhiti,0,0,0,0,3,1,0,4
2020-05-25,Taranaki,0,0,0,0,14,2,0,16
2020-05-25,Waikato,0,0,0,0,153,34,1,187
2020-05-25,Wairarapa,0,0,0,0,6,2,0,8
2020-05-25,Waitemata,0,0,0,0,166,71,4,237
2020-05-25,West Coast,0,0,0,0,4,1,1,5
2020-05-25,Whanganui,0,0,0,0,8,1,0,9
2020-05-24,Auckland,0,0,0,0,125,51,0,176
2020-05-24,Bay of Plenty,0,0,0,0,34,14,0,48
2020-05-24,Canterbury,0,0,0,0,99,65,12,164
2020-05-24,Capital and Coast,0,0,0,0,71,24,2,95
2020-05-24,Counties Manukau,0,0,0,0,110,23,0,133
2020-05-24,Hawke's Bay,0,0,0,0,38,6,0,44
2020-05-24,Hutt Valley,0,0,0,0,17,3,0,20
2020-05-24,Lakes,0,0,0,0,15,1,0,16
2020-05-24,Midcentral,0,0,0,0,27,5,0,32
2020-05-24,Nelson Marlborough,0,0,0,0,37,12,0,49
2020-05-24,Northland,0,0,0,0,26,2,0,28
2020-05-24,South Canterbury,0,0,0,0,15,2,0,17
2020-05-24,Southern,0,0,0,0,186,30,2,216
2020-05-24,Tairawhiti,0,0,0,0,3,1,0,4
2020-05-24,Taranaki,0,0,0,0,14,2,0,16
2020-05-24,Waikato,0,0,0,0,153,34,1,187
2020-05-24,Wairarapa,0,0,0,0,6,2,0,8
2020-05-24,Waitemata,0,0,1,0,166,71,4,237
2020-05-24,West Coast,0,0,0,0,4,1,1,5
2020-05-24,Whanganui,0,0,0,0,8,1,0,9
2020-05-23,Auckland,0,0,0,0,125,51,0,176
2020-05-23,Bay of Plenty,0,0,0,0,34,14,0,48
2020-05-23,Canterbury,0,0,0,0,99,65,12,164
2020-05-23,Capital and Coast,0,0,0,0,71,24,2,95
2020-05-23,Counties Manukau,0,0,0,0,110,23,0,133
2020-05-23,Hawke's Bay,0,0,0,0,38,6,0,44
2020-05-23,Hutt Valley,0,0,0,0,17,3,0,20
2020-05-23,Lakes,0,0,0,0,15,1,0,16
2020-05-23,Midcentral,0,0,0,0,27,5,0,32
2020-05-23,Nelson Marlborough,0,0,0,0,37,12,0,49
2020-05-23,Northland,0,0,0,0,26,2,0,28
2020-05-23,South Canterbury,0,0,0,0,15,2,0,17
2020-05-23,Southern,0,0,0,0,186,30,2,216
2020-05-23,Tairawhiti,0,0,0,0,3,1,0,4
2020-05-23,Taranaki,0,0,0,0,14,2,0,16
2020-05-23,Waikato,0,0,0,0,153,34,1,187
2020-05-23,Wairarapa,0,0,0,0,6,2,0,8
2020-05-23,Waitemata,0,0,0,0,166,71,3,237
2020-05-23,West Coast,0,0,0,0,4,1,1,5
2020-05-23,Whanganui,0,0,0,0,8,1,0,9
2020-05-22,Auckland,1,0,0,1,125,51,0,176
2020-05-22,Bay of Plenty,0,0,0,0,34,14,0,48
2020-05-22,Canterbury,0,0,0,0,99,65,12,164
2020-05-22,Capital and Coast,0,0,0,0,71,24,2,95
2020-05-22,Counties Manukau,0,0,0,0,110,23,0,133
2020-05-22,Hawke's Bay,0,0,0,0,38,6,0,44
2020-05-22,Hutt Valley,0,0,0,0,17,3,0,20
2020-05-22,Lakes,0,0,0,0,15,1,0,16
2020-05-22,Midcentral,0,0,0,0,27,5,0,32
2020-05-22,Nelson Marlborough,0,0,0,0,37,12,0,49
2020-05-22,Northland,0,0,0,0,26,2,0,28
2020-05-22,South Canterbury,0,0,0,0,15,2,0,17
2020-05-22,Southern,0,0,0,0,186,30,2,216
2020-05-22,Tairawhiti,0,0,0,0,3,1,0,4
2020-05-22,Taranaki,0,0,0,0,14,2,0,16
2020-05-22,Waikato,0,0,0,0,153,34,1,187
2020-05-22,Wairarapa,0,0,0,0,6,2,0,8
2020-05-22,Waitemata,0,0,0,0,166,71,3,237
2020-05-22,West Coast,0,0,0,0,4,1,1,5
2020-05-22,Whanganui,0,0,0,0,8,1,0,9
2020-05-21,Auckland,0,0,0,0,124,51,0,175
2020-05-21,Bay of Plenty,0,0,0,0,34,14,0,48
2020-05-21,Canterbury,0,0,0,0,99,65,12,164
2020-05-21,Capital and Coast,0,0,0,0,71,24,2,95
2020-05-21,Counties Manukau,0,0,0,0,110,23,0,133
2020-05-21,Hawke's Bay,0,0,0,0,38,6,0,44
2020-05-21,Hutt Valley,0,0,0,0,17,3,0,20
2020-05-21,Lakes,0,0,0,0,15,1,0,16
2020-05-21,Midcentral,0,0,0,0,27,5,0,32
2020-05-21,Nelson Marlborough,0,0,0,0,37,12,0,49
2020-05-21,Northland,0,0,0,0,26,2,0,28
2020-05-21,South Canterbury,0,0,0,0,15,2,0,17
2020-05-21,Southern,0,0,0,0,186,30,2,216
2020-05-21,Tairawhiti,0,0,0,0,3,1,0,4
2020-05-21,Taranaki,0,0,0,0,14,2,0,16
2020-05-21,Waikato,0,0,0,0,153,34,1,187
2020-05-21,Wairarapa,0,0,0,0,6,2,0,8
2020-05-21,Waitemata,0,0,0,0,166,71,3,237
2020-05-21,West Coast,0,0,0,0,4,1,1,5
2020-05-21,Whanganui,0,0,0,0,8,1,0,9
2020-05-20,Auckland,0,0,0,0,124,51,0,175
2020-05-20,Bay of Plenty,0,0,0,0,34,14,0,48
2020-05-20,Canterbury,0,0,0,0,99,65,12,164
2020-05-20,Capital and Coast,0,0,0,0,71,24,2,95
2020-05-20,Counties Manukau,0,0,0,0,110,23,0,133
2020-05-20,Hawke's Bay,0,0,0,0,38,6,0,44
2020-05-20,Hutt Valley,0,0,0,0,17,3,0,20
2020-05-20,Lakes,0,0,0,0,15,1,0,16
2020-05-20,Midcentral,0,0,0,0,27,5,0,32
2020-05-20,Nelson Marlborough,0,0,0,0,37,12,0,49
2020-05-20,Northland,0,0,0,0,26,2,0,28
2020-05-20,South Canterbury,0,0,0,0,15,2,0,17
2020-05-20,Southern,0,0,0,0,186,30,2,216
2020-05-20,Tairawhiti,0,0,0,0,3,1,0,4
2020-05-20,Taranaki,0,0,0,0,14,2,0,16
2020-05-20,Waikato,0,0,0,0,153,34,1,187
2020-05-20,Wairarapa,0,0,0,0,6,2,0,8
2020-05-20,Waitemata,0,0,0,0,166,71,3,237
2020-05-20,West Coast,0,0,0,0,4,1,1,5
2020-05-20,Whanganui,0,0,0,0,8,1,0,9
2020-05-19,Auckland,0,0,0,0,124,51,0,175
2020-05-19,Bay of Plenty,0,0,0,0,34,14,0,48
2020-05-19,Canterbury,0,0,0,0,99,65,12,164
2020-05-19,Capital and Coast,0,0,0,0,71,24,2,95
2020-05-19,Counties Manukau,0,0,0,0,110,23,0,133
2020-05-19,Hawke's Bay,0,0,0,0,38,6,0,44
2020-05-19,Hutt Valley,0,0,0,0,17,3,0,20
2020-05-19,Lakes,0,0,0,0,15,1,0,16
2020-05-19,Midcentral,0,0,0,0,27,5,0,32
2020-05-19,Nelson Marlborough,0,0,0,0,37,12,0,49
2020-05-19,Northland,0,0,0,0,26,2,0,28
2020-05-19,South Canterbury,0,0,0,0,15,2,0,17
2020-05-19,Southern,0,0,0,0,186,30,2,216
2020-05-19,Tairawhiti,0,0,0,0,3,1,0,4
2020-05-19,Taranaki,0,0,0,0,14,2,0,16
2020-05-19,Waikato,0,0,0,0,153,34,1,187
2020-05-19,Wairarapa,0,0,0,0,6,2,0,8
2020-05-19,Waitemata,0,0,0,0,166,71,3,237
2020-05-19,West Coast,0,0,0,0,4,1,1,5
2020-05-19,Whanganui,0,0,0,0,8,1,0,9
2020-05-18,Auckland,0,0,0,0,124,51,0,175
2020-05-18,Bay of Plenty,0,0,0,0,34,14,0,48
2020-05-18,Canterbury,0,0,0,0,99,65,12,164
2020-05-18,Capital and Coast,0,0,0,0,71,24,2,95
2020-05-18,Counties Manukau,0,0,0,0,110,23,0,133
2020-05-18,Hawke's Bay,0,0,0,0,38,6,0,44
2020-05-18,Hutt Valley,0,0,0,0,17,3,0,20
2020-05-18,Lakes,0,0,0,0,15,1,0,16
2020-05-18,Midcentral,0,0,0,0,27,5,0,32
2020-05-18,Nelson Marlborough,0,0,0,0,37,12,0,49
2020-05-18,Northland,0,0,0,0,26,2,0,28
2020-05-18,South Canterbury,0,0,0,0,15,2,0,17
2020-05-18,Southern,0,0,0,0,186,30,2,216
2020-05-18,Tairawhiti,0,0,0,0,3,1,0,4
2020-05-18,Taranaki,0,0,0,0,14,2,0,16
2020-05-18,Waikato,0,0,0,0,153,34,1,187
2020-05-18,Wairarapa,0,0,0,0,6,2,0,8
2020-05-18,Waitemata,0,0,0,0,166,71,3,237
2020-05-18,West Coast,0,0,0,0,4,1,1,5
2020-05-18,Whanganui,0,0,0,0,8,1,0,9
2020-05-17,Auckland,0,0,0,0,124,51,0,175
2020-05-17,Bay of Plenty,0,0,0,0,34,14,0,48
2020-05-17,Canterbury,0,0,0,0,99,65,12,164
2020-05-17,Capital and Coast,0,0,0,0,71,24,2,95
2020-05-17,Counties Manukau,0,0,0,0,110,23,0,133
2020-05-17,Hawke's Bay,0,0,0,0,38,6,0,44
2020-05-17,Hutt Valley,0,0,0,0,17,3,0,20
2020-05-17,Lakes,0,0,0,0,15,1,0,16
2020-05-17,Midcentral,0,0,0,0,27,5,0,32
2020-05-17,Nelson Marlborough,0,0,0,0,37,12,0,49
2020-05-17,Northland,0,0,0,0,26,2,0,28
2020-05-17,South Canterbury,0,0,0,0,15,2,0,17
2020-05-17,Southern,0,0,0,0,186,30,2,216
2020-05-17,Tairawhiti,0,0,0,0,3,1,0,4
2020-05-17,Taranaki,0,0,0,0,14,2,0,16
2020-05-17,Waikato,0,0,0,0,153,34,1,187
2020-05-17,Wairarapa,0,0,0,0,6,2,0,8
2020-05-17,Waitemata,0,0,0,0,166,71,3,237
2020-05-17,West Coast,0,0,0,0,4,1,1,5
2020-05-17,Whanganui,0,0,0,0,8,1,0,9
2020-05-16,Auckland,0,0,0,0,124,51,0,175
2020-05-16,Bay of Plenty,0,0,0,0,34,14,0,48
2020-05-16,Canterbury,0,0,0,0,99,65,12,164
2020-05-16,Capital and Coast,0,0,0,0,71,24,2,95
2020-05-16,Counties Manukau,0,0,0,0,110,23,0,133
2020-05-16,Hawke's Bay,0,0,0,0,38,6,0,44
2020-05-16,Hutt Valley,0,0,0,0,17,3,0,20
2020-05-16,Lakes,0,0,0,0,15,1,0,16
2020-05-16,Midcentral,0,0,0,0,27,5,0,32
2020-05-16,Nelson Marlborough,0,0,0,0,37,12,0,49
2020-05-16,Northland,0,0,0,0,26,2,0,28
2020-05-16,South Canterbury,0,0,0,0,15,2,0,17
2020-05-16,Southern,0,0,0,0,186,30,2,216
2020-05-16,Tairawhiti,0,0,0,0,3,1,0,4
2020-05-16,Taranaki,0,0,0,0,14,2,0,16
2020-05-16,Waikato,0,0,0,0,153,34,1,187
2020-05-16,Wairarapa,0,0,0,0,6,2,0,8
2020-05-16,Waitemata,0,0,0,0,166,71,3,237
2020-05-16,West Coast,0,0,0,0,4,1,1,5
2020-05-16,Whanganui,0,0,0,0,8,1,0,9
2020-05-15,Auckland,0,0,0,0,124,51,0,175
2020-05-15,Bay of Plenty,0,0,0,0,34,14,0,48
2020-05-15,Canterbury,1,0,0,1,99,65,12,164
2020-05-15,Capital and Coast,0,0,0,0,71,24,2,95
2020-05-15,Counties Manukau,0,0,0,0,110,23,0,133
2020-05-15,Hawke's Bay,0,0,0,0,38,6,0,44
2020-05-15,Hutt Valley,0,0,0,0,17,3,0,20
2020-05-15,Lakes,0,0,0,0,15,1,0,16
2020-05-15,Midcentral,0,0,0,0,27,5,0,32
2020-05-15,Nelson Marlborough,0,0,0,0,37,12,0,49
2020-05-15,Northland,0,0,0,0,26,2,0,28
2020-05-15,South Canterbury,0,0,0,0,15,2,0,17
2020-05-15,Southern,0,0,0,0,186,30,2,216
2020-05-15,Tairawhiti,0,0,0,0,3,1,0,4
2020-05-15,Taranaki,0,0,0,0,14,2,0,16
2020-05-15,Waikato,0,0,0,0,153,34,1,187
2020-05-15,Wairarapa,0,0,0,0,6,2,0,8
2020-05-15,Waitemata,0,0,0,0,166,71,3,237
2020-05-15,West Coast,0,0,0,0,4,1,1,5
2020-05-15,Whanganui,0,0,0,0,8,1,0,9
2020-05-14,Auckland,0,0,0,0,124,51,0,175
2020-05-14,Bay of Plenty,0,0,0,0,34,14,0,48
2020-05-14,Canterbury,0,0,0,0,98,65,12,163
2020-05-14,Capital and Coast,0,0,0,0,71,24,2,95
2020-05-14,Counties Manukau,0,0,0,0,110,23,0,133
2020-05-14,Hawke's Bay,0,0,0,0,38,6,0,44
2020-05-14,Hutt Valley,0,0,0,0,17,3,0,20
2020-05-14,Lakes,0,0,0,0,15,1,0,16
2020-05-14,Midcentral,0,0,0,0,27,5,0,32
2020-05-14,Nelson Marlborough,0,0,0,0,37,12,0,49
2020-05-14,Northland,0,0,0,0,26,2,0,28
2020-05-14,South Canterbury,0,0,0,0,15,2,0,17
2020-05-14,Southern,0,0,0,0,186,30,2,216
2020-05-14,Tairawhiti,0,0,0,0,3,1,0,4
2020-05-14,Taranaki,0,0,0,0,14,2,0,16
2020-05-14,Waikato,0,0,0,0,153,34,1,187
2020-05-14,Wairarapa,0,0,0,0,6,2,0,8
2020-05-14,Waitemata,1,0,0,1,166,71,3,237
2020-05-14,West Coast,0,0,0,0,4,1,1,5
2020-05-14,Whanganui,0,0,0,0,8,1,0,9
2020-05-13,Auckland,0,0,0,0,124,51,0,175
2020-05-13,Bay of Plenty,0,0,0,0,34,14,0,48
2020-05-13,Canterbury,0,0,0,0,98,65,12,163
2020-05-13,Capital and Coast,0,0,0,0,71,24,2,95
2020-05-13,Counties Manukau,0,0,0,0,110,23,0,133
2020-05-13,Hawke's Bay,0,0,0,0,38,6,0,44
2020-05-13,Hutt Valley,0,0,0,0,17,3,0,20
2020-05-13,Lakes,0,0,0,0,15,1,0,16
2020-05-13,Midcentral,0,0,0,0,27,5,0,32
2020-05-13,Nelson Marlborough,0,0,0,0,37,12,0,49
2020-05-13,Northland,0,0,0,0,26,2,0,28
2020-05-13,South Canterbury,0,0,0,0,15,2,0,17
2020-05-13,Southern,0,0,0,0,186,30,2,216
2020-05-13,Tairawhiti,0,0,0,0,3,1,0,4
2020-05-13,Taranaki,0,0,0,0,14,2,0,16
2020-05-13,Waikato,0,0,0,0,153,34,1,187
2020-05-13,Wairarapa,0,0,0,0,6,2,0,8
2020-05-13,Waitemata,0,0,0,0,165,71,3,236
2020-05-13,West Coast,0,0,0,0,4,1,1,5
2020-05-13,Whanganui,0,0,0,0,8,1,0,9
2020-05-12,Auckland,0,0,0,0,124,51,0,175
2020-05-12,Bay of Plenty,0,0,0,0,34,14,0,48
2020-05-12,Canterbury,0,0,0,0,98,65,12,163
2020-05-12,Capital and Coast,0,0,0,0,71,24,2,95
2020-05-12,Counties Manukau,0,0,0,0,110,23,0,133
2020-05-12,Hawke's Bay,0,0,0,0,38,6,0,44
2020-05-12,Hutt Valley,0,0,0,0,17,3,0,20
2020-05-12,Lakes,0,0,0,0,15,1,0,16
2020-05-12,Midcentral,0,0,0,0,27,5,0,32
2020-05-12,Nelson Marlborough,0,0,0,0,37,12,0,49
2020-05-12,Northland,0,0,0,0,26,2,0,28
2020-05-12,South Canterbury,0,0,0,0,15,2,0,17
2020-05-12,Southern,0,0,0,0,186,30,2,216
2020-05-12,Tairawhiti,0,0,0,0,3,1,0,4
2020-05-12,Taranaki,0,0,0,0,14,2,0,16
2020-05-12,Waikato,0,0,0,0,153,34,1,187
2020-05-12,Wairarapa,0,0,0,0,6,2,0,8
2020-05-12,Waitemata,0,0,0,0,165,71,3,236
2020-05-12,West Coast,0,0,0,0,4,1,1,5
2020-05-12,Whanganui,0,0,0,0,8,1,0,9
2020-05-11,Auckland,0,0,0,0,124,51,0,175
2020-05-11,Bay of Plenty,0,0,0,0,34,14,0,48
2020-05-11,Canterbury,0,0,0,0,98,65,12,163
2020-05-11,Capital and Coast,0,0,0,0,71,24,2,95
2020-05-11,Counties Manukau,0,0,0,0,110,23,0,133
2020-05-11,Hawke's Bay,0,0,0,0,38,6,0,44
2020-05-11,Hutt Valley,0,0,0,0,17,3,0,20
2020-05-11,Lakes,0,0,0,0,15,1,0,16
2020-05-11,Midcentral,0,0,0,0,27,5,0,32
2020-05-11,Nelson Marlborough,0,0,0,0,37,12,0,49
2020-05-11,Northland,0,0,0,0,26,2,0,28
2020-05-11,South Canterbury,0,0,0,0,15,2,0,17
2020-05-11,Southern,0,0,0,0,186,30,2,216
2020-05-11,Tairawhiti,0,0,0,0,3,1,0,4
2020-05-11,Taranaki,0,0,0,0,14,2,0,16
2020-05-11,Waikato,0,0,0,0,153,34,1,187
2020-05-11,Wairarapa,0,0,0,0,6,2,0,8
2020-05-11,Waitemata,0,0,0,0,165,71,3,236
2020-05-11,West Coast,0,0,0,0,4,1,1,5
2020-05-11,Whanganui,0,0,0,0,8,1,0,9
2020-05-10,Auckland,0,0,0,0,124,51,0,175
2020-05-10,Bay of Plenty,0,0,0,0,34,14,0,48
2020-05-10,Canterbury,0,0,0,0,98,65,12,163
2020-05-10,Capital and Coast,0,0,0,0,71,24,2,95
2020-05-10,Counties Manukau,0,0,0,0,110,23,0,133
2020-05-10,Hawke's Bay,0,0,0,0,38,6,0,44
2020-05-10,Hutt Valley,0,0,0,0,17,3,0,20
2020-05-10,Lakes,0,0,0,0,15,1,0,16
2020-05-10,Midcentral,0,0,0,0,27,5,0,32
2020-05-10,Nelson Marlborough,0,0,0,0,37,12,0,49
2020-05-10,Northland,0,0,0,0,26,2,0,28
2020-05-10,South Canterbury,0,0,0,0,15,2,0,17
2020-05-10,Southern,0,0,0,0,186,30,2,216
2020-05-10,Tairawhiti,0,0,0,0,3,1,0,4
2020-05-10,Taranaki,0,0,0,0,14,2,0,16
2020-05-10,Waikato,1,0,0,1,153,34,1,187
2020-05-10,Wairarapa,0,0,0,0,6,2,0,8
2020-05-10,Waitemata,2,0,0,2,165,71,3,236
2020-05-10,West Coast,0,0,0,0,4,1,1,5
2020-05-10,Whanganui,0,0,0,0,8,1,0,9
2020-05-09,Auckland,0,0,0,0,124,51,0,175
2020-05-09,Bay of Plenty,0,0,0,0,34,14,0,48
2020-05-09,Canterbury,0,0,0,0,98,65,12,163
2020-05-09,Capital and Coast,0,0,0,0,71,24,2,95
2020-05-09,Counties Manukau,0,0,0,0,110,23,0,133
2020-05-09,Hawke's Bay,0,0,0,0,38,6,0,44
2020-05-09,Hutt Valley,0,0,0,0,17,3,0,20
2020-05-09,Lakes,0,0,0,0,15,1,0,16
2020-05-09,Midcentral,1,0,0,1,27,5,0,32
2020-05-09,Nelson Marlborough,0,0,0,0,37,12,0,49
2020-05-09,Northland,0,0,0,0,26,2,0,28
2020-05-09,South Canterbury,0,0,0,0,15,2,0,17
2020-05-09,Southern,0,0,0,0,186,30,2,216
2020-05-09,Tairawhiti,0,0,0,0,3,1,0,4
2020-05-09,Taranaki,0,0,0,0,14,2,0,16
2020-05-09,Waikato,0,0,0,0,152,34,1,186
2020-05-09,Wairarapa,0,0,0,0,6,2,0,8
2020-05-09,Waitemata,0,0,0,0,163,71,3,234
2020-05-09,West Coast,0,0,0,0,4,1,1,5
2020-05-09,Whanganui,0,0,0,0,8,1,0,9
2020-05-08,Auckland,0,0,0,0,124,51,0,175
2020-05-08,Bay of Plenty,0,0,0,0,34,14,0,48
2020-05-08,Canterbury,0,0,0,0,98,65,12,163
2020-05-08,Capital and Coast,0,0,0,0,71,24,2,95
2020-05-08,Counties Manukau,0,0,0,0,110,23,0,133
2020-05-08,Hawke's Bay,0,0,0,0,38,6,0,44
2020-05-08,Hutt Valley,0,0,0,0,17,3,0,20
2020-05-08,Lakes,0,0,0,0,15,1,0,16
2020-05-08,Midcentral,0,0,0,0,26,5,0,31
2020-05-08,Nelson Marlborough,0,0,0,0,37,12,0,49
2020-05-08,Northland,0,0,0,0,26,2,0,28
2020-05-08,South Canterbury,0,0,0,0,15,2,0,17
2020-05-08,Southern,0,0,0,0,186,30,2,216
2020-05-08,Tairawhiti,0,0,0,0,3,1,0,4
2020-05-08,Taranaki,0,0,0,0,14,2,0,16
2020-05-08,Waikato,0,0,0,0,152,34,1,186
2020-05-08,Wairarapa,0,0,0,0,6,2,0,8
2020-05-08,Waitemata,0,1,0,1,163,71,3,234
2020-05-08,West Coast,0,0,0,0,4,1,1,5
2020-05-08,Whanganui,0,0,0,0,8,1,0,9
2020-05-07,Auckland,0,0,0,0,124,51,0,175
2020-05-07,Bay of Plenty,0,0,0,0,34,14,0,48
2020-05-07,Canterbury,0,0,0,0,98,65,12,163
2020-05-07,Capital and Coast,0,0,0,0,71,24,2,95
2020-05-07,Counties Manukau,0,0,0,0,110,23,0,133
2020-05-07,Hawke's Bay,0,0,0,0,38,6,0,44
2020-05-07,Hutt Valley,0,0,0,0,17,3,0,20
2020-05-07,Lakes,0,0,0,0,15,1,0,16
2020-05-07,Midcentral,0,0,0,0,26,5,0,31
2020-05-07,Nelson Marlborough,0,0,0,0,37,12,0,49
2020-05-07,Northland,0,0,0,0,26,2,0,28
2020-05-07,South Canterbury,0,0,0,0,15,2,0,17
2020-05-07,Southern,0,0,0,0,186,30,2,216
2020-05-07,Tairawhiti,0,0,0,0,3,1,0,4
2020-05-07,Taranaki,0,0,0,0,14,2,0,16
2020-05-07,Waikato,0,0,0,0,152,34,1,186
2020-05-07,Wairarapa,0,0,0,0,6,2,0,8
2020-05-07,Waitemata,1,0,0,1,163,70,3,233
2020-05-07,West Coast,0,0,0,0,4,1,1,5
2020-05-07,Whanganui,0,0,0,0,8,1,0,9
2020-05-06,Auckland,0,0,0,0,124,51,0,175
2020-05-06,Bay of Plenty,0,0,0,0,34,14,0,48
2020-05-06,Canterbury,0,0,0,0,98,65,12,163
2020-05-06,Capital and Coast,0,0,0,0,71,24,2,95
2020-05-06,Counties Manukau,0,0,0,0,110,23,0,133
2020-05-06,Hawke's Bay,0,0,0,0,38,6,0,44
2020-05-06,Hutt Valley,0,0,0,0,17,3,0,20
2020-05-06,Lakes,0,0,0,0,15,1,0,16
2020-05-06,Midcentral,0,0,0,0,26,5,0,31
2020-05-06,Nelson Marlborough,0,0,0,0,37,12,0,49
2020-05-06,Northland,0,0,0,0,26,2,0,28
2020-05-06,South Canterbury,0,0,0,0,15,2,0,17
2020-05-06,Southern,0,0,0,0,186,30,2,216
2020-05-06,Tairawhiti,0,0,0,0,3,1,0,4
2020-05-06,Taranaki,0,0,0,0,14,2,0,16
2020-05-06,Waikato,1,0,0,1,152,34,1,186
2020-05-06,Wairarapa,0,0,0,0,6,2,0,8
2020-05-06,Waitemata,1,0,0,1,162,70,3,232
2020-05-06,West Coast,0,0,0,0,4,1,1,5
2020-05-06,Whanganui,0,0,0,0,8,1,0,9
2020-05-05,Auckland,0,1,0,1,124,51,0,175
2020-05-05,Bay of Plenty,0,0,0,0,34,14,0,48
2020-05-05,Canterbury,0,0,1,0,98,65,12,163
2020-05-05,Capital and Coast,0,0,0,0,71,24,2,95
2020-05-05,Counties Manukau,0,0,0,0,110,23,0,133
2020-05-05,Hawke's Bay,0,0,0,0,38,6,0,44
2020-05-05,Hutt Valley,0,0,0,0,17,3,0,20
2020-05-05,Lakes,0,0,0,0,15,1,0,16
2020-05-05,Midcentral,0,0,0,0,26,5,0,31
2020-05-05,Nelson Marlborough,0,0,0,0,37,12,0,49
2020-05-05,Northland,0,0,0,0,26,2,0,28
2020-05-05,South Canterbury,0,0,0,0,15,2,0,17
2020-05-05,Southern,0,0,0,0,186,30,2,216
2020-05-05,Tairawhiti,0,0,0,0,3,1,0,4
2020-05-05,Taranaki,0,0,0,0,14,2,0,16
2020-05-05,Waikato,0,0,0,0,151,34,1,185
2020-05-05,Wairarapa,0,0,0,0,6,2,0,8
2020-05-05,Waitemata,1,0,0,1,161,70,3,231
2020-05-05,West Coast,0,0,0,0,4,1,1,5
2020-05-05,Whanganui,0,0,0,0,8,1,0,9
2020-05-04,Auckland,0,0,0,0,124,50,0,174
2020-05-04,Bay of Plenty,0,0,0,0,34,14,0,48
2020-05-04,Canterbury,0,0,0,0,98,65,11,163
2020-05-04,Capital and Coast,0,0,0,0,71,24,2,95
2020-05-04,Counties Manukau,0,0,0,0,110,23,0,133
2020-05-04,Hawke's Bay,0,0,0,0,38,6,0,44
2020-05-04,Hutt Valley,0,0,0,0,17,3,0,20
2020-05-04,Lakes,0,0,0,0,15,1,0,16
2020-05-04,Midcentral,0,0,0,0,26,5,0,31
2020-05-04,Nelson Marlborough,0,0,0,0,37,12,0,49
2020-05-04,Northland,0,0,0,0,26,2,0,28
2020-05-04,South Canterbury,0,0,0,0,15,2,0,17
2020-05-04,Southern,0,0,0,0,186,30,2,216
2020-05-04,Tairawhiti,0,0,0,0,3,1,0,4
2020-05-04,Taranaki,0,0,0,0,14,2,0,16
2020-05-04,Waikato,0,0,0,0,151,34,1,185
2020-05-04,Wairarapa,0,0,0,0,6,2,0,8
2020-05-04,Waitemata,0,0,0,0,160,70,3,230
2020-05-04,West Coast,0,0,0,0,4,1,1,5
2020-05-04,Whanganui,0,0,0,0,8,1,0,9
2020-05-03,Auckland,0,0,0,0,124,50,0,174
2020-05-03,Bay of Plenty,0,0,0,0,34,14,0,48
2020-05-03,Canterbury,0,0,0,0,98,65,11,163
2020-05-03,Capital and Coast,0,0,0,0,71,24,2,95
2020-05-03,Counties Manukau,1,0,0,1,110,23,0,133
2020-05-03,Hawke's Bay,0,0,0,0,38,6,0,44
2020-05-03,Hutt Valley,0,0,0,0,17,3,0,20
2020-05-03,Lakes,0,0,0,0,15,1,0,16
2020-05-03,Midcentral,0,0,0,0,26,5,0,31
2020-05-03,Nelson Marlborough,0,0,0,0,37,12,0,49
2020-05-03,Northland,0,0,0,0,26,2,0,28
2020-05-03,South Canterbury,0,0,0,0,15,2,0,17
2020-05-03,Southern,0,0,0,0,186,30,2,216
2020-05-03,Tairawhiti,0,0,0,0,3,1,0,4
2020-05-03,Taranaki,0,0,0,0,14,2,0,16
2020-05-03,Waikato,0,0,0,0,151,34,1,185
2020-05-03,Wairarapa,0,0,0,0,6,2,0,8
2020-05-03,Waitemata,0,0,0,0,160,70,3,230
2020-05-03,West Coast,0,0,0,0,4,1,1,5
2020-05-03,Whanganui,0,0,0,0,8,1,0,9
2020-05-02,Auckland,0,0,0,0,124,50,0,174
2020-05-02,Bay of Plenty,0,0,0,0,34,14,0,48
2020-05-02,Canterbury,0,0,1,0,98,65,11,163
2020-05-02,Capital and Coast,0,0,0,0,71,24,2,95
2020-05-02,Counties Manukau,0,0,0,0,109,23,0,132
2020-05-02,Hawke's Bay,0,0,0,0,38,6,0,44
2020-05-02,Hutt Valley,0,0,0,0,17,3,0,20
2020-05-02,Lakes,0,0,0,0,15,1,0,16
2020-05-02,Midcentral,0,0,0,0,26,5,0,31
2020-05-02,Nelson Marlborough,0,0,0,0,37,12,0,49
2020-05-02,Northland,0,0,0,0,26,2,0,28
2020-05-02,South Canterbury,0,0,0,0,15,2,0,17
2020-05-02,Southern,0,0,0,0,186,30,2,216
2020-05-02,Tairawhiti,0,0,0,0,3,1,0,4
2020-05-02,Taranaki,0,0,0,0,14,2,0,16
2020-05-02,Waikato,0,0,0,0,151,34,1,185
2020-05-02,Wairarapa,0,0,0,0,6,2,0,8
2020-05-02,Waitemata,0,0,0,0,160,70,3,230
2020-05-02,West Coast,0,0,0,0,4,1,1,5
2020-05-02,Whanganui,0,0,0,0,8,1,0,9
2020-05-01,Auckland,1,1,0,2,124,50,0,174
2020-05-01,Bay of Plenty,0,0,0,0,34,14,0,48
2020-05-01,Canterbury,1,0,0,1,98,65,10,163
2020-05-01,Capital and Coast,0,0,0,0,71,24,2,95
2020-05-01,Counties Manukau,0,0,0,0,109,23,0,132
2020-05-01,Hawke's Bay,0,0,0,0,38,6,0,44
2020-05-01,Hutt Valley,0,0,0,0,17,3,0,20
2020-05-01,Lakes,0,0,0,0,15,1,0,16
2020-05-01,Midcentral,0,0,0,0,26,5,0,31
2020-05-01,Nelson Marlborough,0,0,0,0,37,12,0,49
2020-05-01,Northland,0,0,0,0,26,2,0,28
2020-05-01,South Canterbury,0,0,0,0,15,2,0,17
2020-05-01,Southern,0,0,0,0,186,30,2,216
2020-05-01,Tairawhiti,0,0,0,0,3,1,0,4
2020-05-01,Taranaki,0,0,0,0,14,2,0,16
2020-05-01,Waikato,0,0,0,0,151,34,1,185
2020-05-01,Wairarapa,0,0,0,0,6,2,0,8
2020-05-01,Waitemata,1,1,0,2,160,70,3,230
2020-05-01,West Coast,0,0,0,0,4,1,1,5
2020-05-01,Whanganui,0,0,0,0,8,1,0,9
2020-04-30,Auckland,2,0,0,2,123,49,0,172
2020-04-30,Bay of Plenty,0,0,0,0,34,14,0,48
2020-04-30,Canterbury,0,0,0,0,97,65,10,162
2020-04-30,Capital and Coast,0,0,0,0,71,24,2,95
2020-04-30,Counties Manukau,0,0,0,0,109,23,0,132
2020-04-30,Hawke's Bay,0,0,0,0,38,6,0,44
2020-04-30,Hutt Valley,0,0,0,0,17,3,0,20
2020-04-30,Lakes,0,0,0,0,15,1,0,16
2020-04-30,Midcentral,0,0,0,0,26,5,0,31
2020-04-30,Nelson Marlborough,0,0,0,0,37,12,0,49
2020-04-30,Northland,0,0,0,0,26,2,0,28
2020-04-30,South Canterbury,0,0,0,0,15,2,0,17
2020-04-30,Southern,0,0,0,0,186,30,2,216
2020-04-30,Tairawhiti,0,0,0,0,3,1,0,4
2020-04-30,Taranaki,0,0,0,0,14,2,0,16
2020-04-30,Waikato,0,0,0,0,151,34,1,185
2020-04-30,Wairarapa,0,0,0,0,6,2,0,8
2020-04-30,Waitemata,1,0,0,1,159,69,3,228
2020-04-30,West Coast,0,0,0,0,4,1,1,5
2020-04-30,Whanganui,0,0,0,0,8,1,0,9
2020-04-29,Auckland,0,0,0,0,121,49,0,170
2020-04-29,Bay of Plenty,0,0,0,0,34,14,0,48
2020-04-29,Canterbury,0,0,0,0,97,65,10,162
2020-04-29,Capital and Coast,0,0,0,0,71,24,2,95
2020-04-29,Counties Manukau,1,0,0,1,109,23,0,132
2020-04-29,Hawke's Bay,0,0,0,0,38,6,0,44
2020-04-29,Hutt Valley,0,0,0,0,17,3,0,20
2020-04-29,Lakes,0,0,0,0,15,1,0,16
2020-04-29,Midcentral,0,0,0,0,26,5,0,31
2020-04-29,Nelson Marlborough,1,0,0,1,37,12,0,49
2020-04-29,Northland,0,0,0,0,26,2,0,28
2020-04-29,South Canterbury,0,0,0,0,15,2,0,17
2020-04-29,Southern,0,0,0,0,186,30,2,216
2020-04-29,Tairawhiti,0,0,0,0,3,1,0,4
2020-04-29,Taranaki,0,0,0,0,14,2,0,16
2020-04-29,Waikato,0,0,0,0,151,34,1,185
2020-04-29,Wairarapa,0,0,0,0,6,2,0,8
2020-04-29,Waitemata,0,0,0,0,158,69,3,227
2020-04-29,West Coast,0,0,0,0,4,1,1,5
2020-04-29,Whanganui,0,0,0,0,8,1,0,9
2020-04-28,Auckland,0,0,0,0,121,49,0,170
2020-04-28,Bay of Plenty,0,0,0,0,34,14,0,48
2020-04-28,Canterbury,0,0,0,0,97,65,10,162
2020-04-28,Capital and Coast,0,0,0,0,71,24,2,95
2020-04-28,Counties Manukau,1,0,0,1,108,23,0,131
2020-04-28,Hawke's Bay,0,0,0,0,38,6,0,44
2020-04-28,Hutt Valley,0,0,0,0,17,3,0,20
2020-04-28,Lakes,0,0,0,0,15,1,0,16
2020-04-28,Midcentral,0,0,0,0,26,5,0,31
2020-04-28,Nelson Marlborough,0,0,0,0,36,12,0,48
2020-04-28,Northland,0,0,0,0,26,2,0,28
2020-04-28,South Canterbury,0,0,0,0,15,2,0,17
2020-04-28,Southern,0,0,0,0,186,30,2,216
2020-04-28,Tairawhiti,0,0,0,0,3,1,0,4
2020-04-28,Taranaki,0,0,0,0,14,2,0,16
2020-04-28,Waikato,0,0,0,0,151,34,1,185
2020-04-28,Wairarapa,0,0,0,0,6,2,0,8
2020-04-28,Waitemata,0,0,0,0,158,69,3,227
2020-04-28,West Coast,0,0,0,0,4,1,1,5
2020-04-28,Whanganui,0,0,0,0,8,1,0,9
2020-04-27,Auckland,0,0,0,0,121,49,0,170
2020-04-27,Bay of Plenty,0,0,0,0,34,14,0,48
2020-04-27,Canterbury,0,0,0,0,97,65,10,162
2020-04-27,Capital and Coast,0,0,0,0,71,24,2,95
2020-04-27,Counties Manukau,0,0,0,0,107,23,0,130
2020-04-27,Hawke's Bay,1,0,0,1,38,6,0,44
2020-04-27,Hutt Valley,0,0,0,0,17,3,0,20
2020-04-27,Lakes,0,0,0,0,15,1,0,16
2020-04-27,Midcentral,0,0,0,0,26,5,0,31
2020-04-27,Nelson Marlborough,0,0,0,0,36,12,0,48
2020-04-27,Northland,0,0,0,0,26,2,0,28
2020-04-27,South Canterbury,0,0,0,0,15,2,0,17
2020-04-27,Southern,0,0,0,0,186,30,2,216
2020-04-27,Tairawhiti,0,0,0,0,3,1,0,4
2020-04-27,Taranaki,0,0,0,0,14,2,0,16
2020-04-27,Waikato,0,0,0,0,151,34,1,185
2020-04-27,Wairarapa,0,0,0,0,6,2,0,8
2020-04-27,Waitemata,2,0,0,2,158,69,3,227
2020-04-27,West Coast,0,0,0,0,4,1,1,5
2020-04-27,Whanganui,0,0,0,0,8,1,0,9
2020-04-26,Auckland,0,0,0,0,121,49,0,170
2020-04-26,Bay of Plenty,0,0,0,0,34,14,0,48
2020-04-26,Canterbury,0,0,0,0,97,65,10,162
2020-04-26,Capital and Coast,0,0,0,0,71,24,2,95
2020-04-26,Counties Manukau,0,0,0,0,107,23,0,130
2020-04-26,Hawke's Bay,1,0,0,1,37,6,0,43
2020-04-26,Hutt Valley,0,0,0,0,17,3,0,20
2020-04-26,Lakes,0,0,0,0,15,1,0,16
2020-04-26,Midcentral,0,0,0,0,26,5,0,31
2020-04-26,Nelson Marlborough,0,0,0,0,36,12,0,48
2020-04-26,Northland,0,0,0,0,26,2,0,28
2020-04-26,South Canterbury,0,0,0,0,15,2,0,17
2020-04-26,Southern,0,0,0,0,186,30,2,216
2020-04-26,Tairawhiti,0,0,0,0,3,1,0,4
2020-04-26,Taranaki,0,1,0,1,14,2,0,16
2020-04-26,Waikato,0,0,0,0,151,34,1,185
2020-04-26,Wairarapa,0,0,0,0,6,2,0,8
2020-04-26,Waitemata,1,0,1,1,156,69,3,225
2020-04-26,West Coast,0,0,0,0,4,1,1,5
2020-04-26,Whanganui,0,0,0,0,8,1,0,9
2020-04-25,Auckland,0,1,0,1,121,49,0,170
2020-04-25,Bay of Plenty,0,0,0,0,34,14,0,48
2020-04-25,Canterbury,0,0,0,0,97,65,10,162
2020-04-25,Capital and Coast,0,0,0,0,71,24,2,95
2020-04-25,Counties Manukau,0,0,0,0,107,23,0,130
2020-04-25,Hawke's Bay,0,0,0,0,36,6,0,42
2020-04-25,Hutt Valley,0,0,0,0,17,3,0,20
2020-04-25,Lakes,0,0,0,0,15,1,0,16
2020-04-25,Midcentral,0,0,0,0,26,5,0,31
2020-04-25,Nelson Marlborough,0,0,0,0,36,12,0,48
2020-04-25,Northland,0,0,0,0,26,2,0,28
2020-04-25,South Canterbury,0,1,0,1,15,2,0,17
2020-04-25,Southern,0,0,0,0,186,30,2,216
2020-04-25,Tairawhiti,0,0,0,0,3,1,0,4
2020-04-25,Taranaki,1,0,0,1,14,1,0,15
2020-04-25,Waikato,0,0,0,0,151,34,1,185
2020-04-25,Wairarapa,0,0,0,0,6,2,0,8
2020-04-25,Waitemata,0,3,0,3,155,69,2,224
2020-04-25,West Coast,0,0,0,0,4,1,1,5
2020-04-25,Whanganui,0,0,0,0,8,1,0,9
2020-04-24,Auckland,0,0,0,0,121,48,0,169
2020-04-24,Bay of Plenty,0,0,0,0,34,14,0,48
2020-04-24,Canterbury,1,1,1,2,97,65,10,162
2020-04-24,Capital and Coast,0,0,0,0,71,24,2,95
2020-04-24,Counties Manukau,0,1,0,1,107,23,0,130
2020-04-24,Hawke's Bay,0,0,0,0,36,6,0,42
2020-04-24,Hutt Valley,0,0,0,0,17,3,0,20
2020-04-24,Lakes,0,0,0,0,15,1,0,16
2020-04-24,Midcentral,0,0,0,0,26,5,0,31
2020-04-24,Nelson Marlborough,0,0,0,0,36,12,0,48
2020-04-24,Northland,0,0,0,0,26,2,0,28
2020-04-24,South Canterbury,0,0,0,0,15,1,0,16
2020-04-24,Southern,0,0,0,0,186,30,2,216
2020-04-24,Tairawhiti,0,0,0,0,3,1,0,4
2020-04-24,Taranaki,0,0,0,0,13,1,0,14
2020-04-24,Waikato,0,0,0,0,151,34,1,185
2020-04-24,Wairarapa,0,0,0,0,6,2,0,8
2020-04-24,Waitemata,3,0,1,3,155,66,2,221
2020-04-24,West Coast,0,0,0,0,4,1,1,5
2020-04-24,Whanganui,0,0,0,0,8,1,0,9
2020-04-23,Auckland,0,0,0,0,121,48,0,169
2020-04-23,Bay of Plenty,0,0,0,0,34,14,0,48
2020-04-23,Canterbury,2,0,0,2,96,64,9,160
2020-04-23,Capital and Coast,0,0,0,0,71,24,2,95
2020-04-23,Counties Manukau,0,0,0,0,107,22,0,129
2020-04-23,Hawke's Bay,0,0,0,0,36,6,0,42
2020-04-23,Hutt Valley,0,0,0,0,17,3,0,20
2020-04-23,Lakes,0,0,0,0,15,1,0,16
2020-04-23,Midcentral,0,0,0,0,26,5,0,31
2020-04-23,Nelson Marlborough,0,0,0,0,36,12,0,48
2020-04-23,Northland,0,0,0,0,26,2,0,28
2020-04-23,South Canterbury,0,0,0,0,15,1,0,16
2020-04-23,Southern,0,0,0,0,186,30,2,216
2020-04-23,Tairawhiti,0,0,0,0,3,1,0,4
2020-04-23,Taranaki,0,0,0,0,13,1,0,14
2020-04-23,Waikato,0,1,0,1,151,34,1,185
2020-04-23,Wairarapa,0,0,0,0,6,2,0,8
2020-04-23,Waitemata,1,1,0,2,152,66,1,218
2020-04-23,West Coast,0,0,0,0,4,1,1,5
2020-04-23,Whanganui,0,0,0,0,8,1,0,9
2020-04-22,Auckland,0,0,0,0,121,48,0,169
2020-04-22,Bay of Plenty,0,0,0,0,34,14,0,48
2020-04-22,Canterbury,0,2,1,2,94,64,9,158
2020-04-22,Capital and Coast,0,0,0,0,71,24,2,95
2020-04-22,Counties Manukau,1,0,0,1,107,22,0,129
2020-04-22,Hawke's Bay,1,0,0,1,36,6,0,42
2020-04-22,Hutt Valley,0,0,0,0,17,3,0,20
2020-04-22,Lakes,0,0,0,0,15,1,0,16
2020-04-22,Midcentral,0,0,0,0,26,5,0,31
2020-04-22,Nelson Marlborough,0,0,0,0,36,12,0,48
2020-04-22,Northland,0,0,0,0,26,2,0,28
2020-04-22,South Canterbury,0,0,0,0,15,1,0,16
2020-04-22,Southern,0,0,1,0,186,30,2,216
2020-04-22,Tairawhiti,0,0,0,0,3,1,0,4
2020-04-22,Taranaki,0,0,0,0,13,1,0,14
2020-04-22,Waikato,0,1,0,1,151,33,1,184
2020-04-22,Wairarapa,0,0,0,0,6,2,0,8
2020-04-22,Waitemata,0,0,0,0,151,65,1,216
2020-04-22,West Coast,0,0,0,0,4,1,1,5
2020-04-22,Whanganui,0,0,0,0,8,1,0,9
2020-04-21,Auckland,0,1,0,1,121,48,0,169
2020-04-21,Bay of Plenty,0,0,0,0,34,14,0,48
2020-04-21,Canterbury,0,2,1,2,94,62,8,156
2020-04-21,Capital and Coast,0,0,0,0,71,24,2,95
2020-04-21,Counties Manukau,0,2,0,2,106,22,0,128
2020-04-21,Hawke's Bay,0,0,0,0,35,6,0,41
2020-04-21,Hutt Valley,0,0,0,0,17,3,0,20
2020-04-21,Lakes,0,0,0,0,15,1,0,16
2020-04-21,Midcentral,0,0,0,0,26,5,0,31
2020-04-21,Nelson Marlborough,0,0,0,0,36,12,0,48
2020-04-21,Northland,0,0,0,0,26,2,0,28
2020-04-21,South Canterbury,0,0,0,0,15,1,0,16
2020-04-21,Southern,0,0,0,0,186,30,1,216
2020-04-21,Tairawhiti,0,0,0,0,3,1,0,4
2020-04-21,Taranaki,0,0,0,0,13,1,0,14
2020-04-21,Waikato,1,0,0,1,151,32,1,183
2020-04-21,Wairarapa,0,0,0,0,6,2,0,8
2020-04-21,Waitemata,0,0,0,0,151,65,1,216
2020-04-21,West Coast,0,0,0,0,4,1,1,5
2020-04-21,Whanganui,0,0,0,0,8,1,0,9
2020-04-20,Auckland,0,0,0,0,121,47,0,168
2020-04-20,Bay of Plenty,0,0,0,0,34,14,0,48
2020-04-20,Canterbury,0,1,0,1,94,60,7,154
2020-04-20,Capital and Coast,0,2,0,2,71,24,2,95
2020-04-20,Counties Manukau,0,0,0,0,106,20,0,126
2020-04-20,Hawke's Bay,0,0,0,0,35,6,0,41
2020-04-20,Hutt Valley,0,0,0,0,17,3,0,20
2020-04-20,Lakes,0,0,0,0,15,1,0,16
2020-04-20,Midcentral,0,0,0,0,26,5,0,31
2020-04-20,Nelson Marlborough,0,0,0,0,36,12,0,48
2020-04-20,Northland,0,0,0,0,26,2,0,28
2020-04-20,South Canterbury,0,0,0,0,15,1,0,16
2020-04-20,Southern,0,0,0,0,186,30,1,216
2020-04-20,Tairawhiti,0,0,0,0,3,1,0,4
2020-04-20,Taranaki,0,0,0,0,13,1,0,14
2020-04-20,Waikato,0,0,0,0,150,32,1,182
2020-04-20,Wairarapa,0,0,0,0,6,2,0,8
2020-04-20,Waitemata,0,0,1,0,151,65,1,216
2020-04-20,West Coast,0,0,0,0,4,1,1,5
2020-04-20,Whanganui,0,0,0,0,8,1,0,9
2020-04-19,Auckland,0,0,0,0,121,47,0,168
2020-04-19,Bay of Plenty,2,0,0,2,34,14,0,48
2020-04-19,Canterbury,3,0,0,3,94,59,7,153
2020-04-19,Capital and Coast,0,0,0,0,71,22,2,93
2020-04-19,Counties Manukau,1,0,0,1,106,20,0,126
2020-04-19,Hawke's Bay,0,0,0,0,35,6,0,41
2020-04-19,Hutt Valley,0,0,0,0,17,3,0,20
2020-04-19,Lakes,0,0,0,0,15,1,0,16
2020-04-19,Midcentral,0,0,0,0,26,5,0,31
2020-04-19,Nelson Marlborough,0,0,0,0,36,12,0,48
2020-04-19,Northland,0,0,0,0,26,2,0,28
2020-04-19,South Canterbury,1,0,0,1,15,1,0,16
2020-04-19,Southern,0,0,0,0,186,30,1,216
2020-04-19,Tairawhiti,0,0,0,0,3,1,0,4
2020-04-19,Taranaki,0,0,0,0,13,1,0,14
2020-04-19,Waikato,0,1,0,1,150,32,1,182
2020-04-19,Wairarapa,0,0,0,0,6,2,0,8
2020-04-19,Waitemata,0,1,0,1,151,65,0,216
2020-04-19,West Coast,0,0,0,0,4,1,1,5
2020-04-19,Whanganui,0,1,0,1,8,1,0,9
2020-04-18,Auckland,0,1,0,1,121,47,0,168
2020-04-18,Bay of Plenty,0,0,0,0,32,14,0,46
2020-04-18,Canterbury,2,0,0,2,91,59,7,150
2020-04-18,Capital and Coast,0,0,0,0,71,22,2,93
2020-04-18,Counties Manukau,2,0,0,2,105,20,0,125
2020-04-18,Hawke's Bay,0,0,0,0,35,6,0,41
2020-04-18,Hutt Valley,0,0,0,0,17,3,0,20
2020-04-18,Lakes,0,0,0,0,15,1,0,16
2020-04-18,Midcentral,0,0,0,0,26,5,0,31
2020-04-18,Nelson Marlborough,0,0,0,0,36,12,0,48
2020-04-18,Northland,0,0,0,0,26,2,0,28
2020-04-18,South Canterbury,0,0,0,0,14,1,0,15
2020-04-18,Southern,0,0,0,0,186,30,1,216
2020-04-18,Tairawhiti,0,0,0,0,3,1,0,4
2020-04-18,Taranaki,0,0,0,0,13,1,0,14
2020-04-18,Waikato,0,1,0,1,150,31,1,181
2020-04-18,Wairarapa,0,0,0,0,6,2,0,8
2020-04-18,Waitemata,1,3,0,4,151,64,0,215
2020-04-18,West Coast,0,0,0,0,4,1,1,5
2020-04-18,Whanganui,0,0,0,0,8,0,0,8
2020-04-17,Auckland,0,1,0,1,121,46,0,167
2020-04-17,Bay of Plenty,1,0,0,1,32,14,0,46
2020-04-17,Canterbury,0,0,0,0,89,59,7,148
2020-04-17,Capital and Coast,0,1,0,1,71,22,2,93
2020-04-17,Counties Manukau,0,1,0,1,103,20,0,123
2020-04-17,Hawke's Bay,0,0,0,0,35,6,0,41
2020-04-17,Hutt Valley,0,0,0,0,17,3,0,20
2020-04-17,Lakes,1,0,0,1,15,1,0,16
2020-04-17,Midcentral,2,0,0,2,26,5,0,31
2020-04-17,Nelson Marlborough,0,0,0,0,36,12,0,48
2020-04-17,Northland,0,0,0,0,26,2,0,28
2020-04-17,South Canterbury,1,0,0,1,14,1,0,15
2020-04-17,Southern,0,2,0,2,186,30,1,216
2020-04-17,Tairawhiti,0,0,0,0,3,1,0,4
2020-04-17,Taranaki,0,0,0,0,13,1,0,14
2020-04-17,Waikato,0,0,0,0,150,30,1,180
2020-04-17,Wairarapa,0,0,0,0,6,2,0,8
2020-04-17,Waitemata,0,1,0,1,150,61,0,211
2020-04-17,West Coast,0,0,0,0,4,1,1,5
2020-04-17,Whanganui,1,0,0,1,8,0,0,8
2020-04-16,Auckland,1,1,0,2,121,45,0,166
2020-04-16,Bay of Plenty,0,0,0,0,31,14,0,45
2020-04-16,Canterbury,3,0,1,3,89,59,7,148
2020-04-16,Capital and Coast,1,0,0,1,71,21,2,92
2020-04-16,Counties Manukau,3,0,0,3,103,19,0,122
2020-04-16,Hawke's Bay,0,0,0,0,35,6,0,41
2020-04-16,Hutt Valley,0,0,0,0,17,3,0,20
2020-04-16,Lakes,0,0,0,0,14,1,0,15
2020-04-16,Midcentral,0,0,0,0,24,5,0,29
2020-04-16,Nelson Marlborough,0,0,0,0,36,12,0,48
2020-04-16,Northland,1,0,0,1,26,2,0,28
2020-04-16,South Canterbury,0,0,0,0,13,1,0,14
2020-04-16,Southern,0,1,0,1,186,28,1,214
2020-04-16,Tairawhiti,0,0,0,0,3,1,0,4
2020-04-16,Taranaki,0,0,0,0,13,1,0,14
2020-04-16,Waikato,0,1,1,1,150,30,1,180
2020-04-16,Wairarapa,0,0,0,0,6,2,0,8
2020-04-16,Waitemata,4,1,0,5,150,60,0,210
2020-04-16,West Coast,0,0,0,0,4,1,1,5
2020-04-16,Whanganui,0,0,0,0,7,0,0,7
2020-04-15,Auckland,0,0,0,0,120,44,0,164
2020-04-15,Bay of Plenty,0,0,0,0,31,14,0,45
2020-04-15,Canterbury,1,1,0,2,86,59,6,145
2020-04-15,Capital and Coast,0,3,0,3,70,21,2,91
2020-04-15,Counties Manukau,0,0,0,0,100,19,0,119
2020-04-15,Hawke's Bay,0,0,0,0,35,6,0,41
2020-04-15,Hutt Valley,0,0,0,0,17,3,0,20
2020-04-15,Lakes,0,0,0,0,14,1,0,15
2020-04-15,Midcentral,0,1,0,1,24,5,0,29
2020-04-15,Nelson Marlborough,0,0,0,0,36,12,0,48
2020-04-15,Northland,0,0,0,0,25,2,0,27
2020-04-15,South Canterbury,1,0,0,1,13,1,0,14
2020-04-15,Southern,1,0,0,1,186,27,1,213
2020-04-15,Tairawhiti,0,0,0,0,3,1,0,4
2020-04-15,Taranaki,0,0,0,0,13,1,0,14
2020-04-15,Waikato,0,2,0,2,150,29,0,179
2020-04-15,Wairarapa,0,0,0,0,6,2,0,8
2020-04-15,Waitemata,1,0,0,1,146,59,0,205
2020-04-15,West Coast,0,0,0,0,4,1,1,5
2020-04-15,Whanganui,0,0,0,0,7,0,0,7
2020-04-14,Auckland,0,1,0,1,120,44,0,164
2020-04-14,Bay of Plenty,0,3,0,3,31,14,0,45
2020-04-14,Canterbury,1,0,0,1,85,58,6,143
2020-04-14,Capital and Coast,0,0,0,0,70,18,2,88
2020-04-14,Counties Manukau,4,1,0,5,100,19,0,119
2020-04-14,Hawke's Bay,0,0,0,0,35,6,0,41
2020-04-14,Hutt Valley,0,0,0,0,17,3,0,20
2020-04-14,Lakes,0,0,0,0,14,1,0,15
2020-04-14,Midcentral,0,0,0,0,24,4,0,28
2020-04-14,Nelson Marlborough,0,0,0,0,36,12,0,48
2020-04-14,Northland,0,0,0,0,25,2,0,27
2020-04-14,South Canterbury,1,0,0,1,12,1,0,13
2020-04-14,Southern,0,2,1,2,185,27,1,212
2020-04-14,Tairawhiti,2,0,0,2,3,1,0,4
2020-04-14,Taranaki,0,0,0,0,13,1,0,14
2020-04-14,Waikato,0,1,0,1,150,27,0,177
2020-04-14,Wairarapa,0,0,0,0,6,2,0,8
2020-04-14,Waitemata,0,0,0,0,145,59,0,204
2020-04-14,West Coast,0,0,0,0,4,1,1,5
2020-04-14,Whanganui,0,0,0,0,7,0,0,7
2020-04-13,Auckland,0,1,0,1,120,43,0,163
2020-04-13,Bay of Plenty,0,0,0,0,31,11,0,42
2020-04-13,Canterbury,1,0,3,1,84,58,6,142
2020-04-13,Capital and Coast,0,0,1,0,70,18,2,88
2020-04-13,Counties Manukau,0,1,0,1,96,18,0,114
2020-04-13,Hawke's Bay,0,0,0,0,35,6,0,41
2020-04-13,Hutt Valley,0,0,0,0,17,3,0,20
2020-04-13,Lakes,0,0,0,0,14,1,0,15
2020-04-13,Midcentral,0,0,0,0,24,4,0,28
2020-04-13,Nelson Marlborough,0,0,0,0,36,12,0,48
2020-04-13,Northland,1,0,0,1,25,2,0,27
2020-04-13,South Canterbury,0,0,0,0,11,1,0,12
2020-04-13,Southern,0,1,0,1,185,25,0,210
2020-04-13,Tairawhiti,0,0,0,0,1,1,0,2
2020-04-13,Taranaki,0,0,0,0,13,1,0,14
2020-04-13,Waikato,0,0,0,0,150,26,0,176
2020-04-13,Wairarapa,0,0,0,0,6,2,0,8
2020-04-13,Waitemata,1,5,0,6,145,59,0,204
2020-04-13,West Coast,0,0,0,0,4,1,1,5
2020-04-13,Whanganui,0,0,0,0,7,0,0,7
2020-04-12,Auckland,0,3,0,3,120,42,0,162
2020-04-12,Bay of Plenty,0,0,0,0,31,11,0,42
2020-04-12,Canterbury,2,1,1,3,83,58,3,141
2020-04-12,Capital and Coast,1,1,0,2,70,18,1,88
2020-04-12,Counties Manukau,0,0,0,0,96,17,0,113
2020-04-12,Hawke's Bay,2,0,0,2,35,6,0,41
2020-04-12,Hutt Valley,0,0,0,0,17,3,0,20
2020-04-12,Lakes,2,0,0,2,14,1,0,15
2020-04-12,Midcentral,0,0,0,0,24,4,0,28
2020-04-12,Nelson Marlborough,0,0,0,0,36,12,0,48
2020-04-12,Northland,0,0,0,0,24,2,0,26
2020-04-12,South Canterbury,0,0,0,0,11,1,0,12
2020-04-12,Southern,0,4,0,4,185,24,0,209
2020-04-12,Tairawhiti,0,0,0,0,1,1,0,2
2020-04-12,Taranaki,0,0,0,0,13,1,0,14
2020-04-12,Waikato,0,0,0,0,150,26,0,176
2020-04-12,Wairarapa,0,0,0,0,6,2,0,8
2020-04-12,Waitemata,4,0,0,4,144,54,0,198
2020-04-12,West Coast,0,0,0,0,4,1,1,5
2020-04-12,Whanganui,0,0,0,0,7,0,0,7
2020-04-11,Auckland,1,2,0,3,120,39,0,159
2020-04-11,Bay of Plenty,0,0,0,0,31,11,0,42
2020-04-11,Canterbury,0,1,0,1,81,57,2,138
2020-04-11,Capital and Coast,0,0,0,0,69,17,1,86
2020-04-11,Counties Manukau,1,0,0,1,96,17,0,113
2020-04-11,Hawke's Bay,0,0,0,0,33,6,0,39
2020-04-11,Hutt Valley,0,0,0,0,17,3,0,20
2020-04-11,Lakes,0,0,0,0,12,1,0,13
2020-04-11,Midcentral,0,0,0,0,24,4,0,28
2020-04-11,Nelson Marlborough,0,0,0,0,36,12,0,48
2020-04-11,Northland,1,0,0,1,24,2,0,26
2020-04-11,South Canterbury,1,0,0,1,11,1,0,12
2020-04-11,Southern,0,0,0,0,185,20,0,205
2020-04-11,Tairawhiti,0,1,0,1,1,1,0,2
2020-04-11,Taranaki,0,0,0,0,13,1,0,14
2020-04-11,Waikato,4,5,0,9,150,26,0,176
2020-04-11,Wairarapa,0,0,0,0,6,2,0,8
2020-04-11,Waitemata,5,3,0,8,140,54,0,194
2020-04-11,West Coast,0,0,0,0,4,1,1,5
2020-04-11,Whanganui,0,0,0,0,7,0,0,7
2020-04-10,Auckland,0,4,0,4,119,37,0,156
2020-04-10,Bay of Plenty,1,1,0,2,31,11,0,42
2020-04-10,Canterbury,0,2,1,2,81,56,2,137
2020-04-10,Capital and Coast,0,0,1,0,69,17,1,86
2020-04-10,Counties Manukau,1,0,0,1,95,17,0,112
2020-04-10,Hawke's Bay,0,1,0,1,33,6,0,39
2020-04-10,Hutt Valley,0,0,0,0,17,3,0,20
2020-04-10,Lakes,0,1,0,1,12,1,0,13
2020-04-10,Midcentral,0,0,0,0,24,4,0,28
2020-04-10,Nelson Marlborough,0,0,0,0,36,12,0,48
2020-04-10,Northland,2,0,0,2,23,2,0,25
2020-04-10,South Canterbury,0,0,0,0,10,1,0,11
2020-04-10,Southern,0,5,0,5,185,20,0,205
2020-04-10,Tairawhiti,0,0,0,0,1,0,0,1
2020-04-10,Taranaki,0,0,0,0,13,1,0,14
2020-04-10,Waikato,0,2,0,2,146,21,0,167
2020-04-10,Wairarapa,0,0,0,0,6,2,0,8
2020-04-10,Waitemata,4,3,0,7,135,51,0,186
2020-04-10,West Coast,0,0,0,0,4,1,1,5
2020-04-10,Whanganui,0,0,0,0,7,0,0,7
2020-04-09,Auckland,8,3,0,11,119,33,0,152
2020-04-09,Bay of Plenty,0,2,0,2,30,10,0,40
2020-04-09,Canterbury,5,5,1,10,81,54,1,135
2020-04-09,Capital and Coast,2,0,0,2,69,17,0,86
2020-04-09,Counties Manukau,5,0,0,5,94,17,0,111
2020-04-09,Hawke's Bay,1,1,0,2,33,5,0,38
2020-04-09,Hutt Valley,0,0,0,0,17,3,0,20
2020-04-09,Lakes,0,0,0,0,12,0,0,12
2020-04-09,Midcentral,0,0,0,0,24,4,0,28
2020-04-09,Nelson Marlborough,0,0,0,0,36,12,0,48
2020-04-09,Northland,0,1,0,1,21,2,0,23
2020-04-09,South Canterbury,0,0,0,0,10,1,0,11
2020-04-09,Southern,2,2,0,4,185,15,0,200
2020-04-09,Tairawhiti,0,0,0,0,1,0,0,1
2020-04-09,Taranaki,0,0,0,0,13,1,0,14
2020-04-09,Waikato,3,0,0,3,146,19,0,165
2020-04-09,Wairarapa,0,0,0,0,6,2,0,8
2020-04-09,Waitemata,4,0,0,4,131,48,0,179
2020-04-09,West Coast,0,0,0,0,4,1,1,5
2020-04-09,Whanganui,0,0,0,0,7,0,0,7
2020-04-08,Auckland,3,1,0,4,111,30,0,141
2020-04-08,Bay of Plenty,0,0,0,0,30,8,0,38
2020-04-08,Canterbury,1,5,0,6,76,49,0,125
2020-04-08,Capital and Coast,3,0,0,3,67,17,0,84
2020-04-08,Counties Manukau,2,0,0,2,89,17,0,106
2020-04-08,Hawke's Bay,1,0,0,1,32,4,0,36
2020-04-08,Hutt Valley,0,0,0,0,17,3,0,20
2020-04-08,Lakes,0,0,0,0,12,0,0,12
2020-04-08,Midcentral,0,0,0,0,24,4,0,28
2020-04-08,Nelson Marlborough,0,0,0,0,36,12,0,48
2020-04-08,Northland,0,0,0,0,21,1,0,22
2020-04-08,South Canterbury,1,0,0,1,10,1,0,11
2020-04-08,Southern,2,1,0,3,183,13,0,196
2020-04-08,Tairawhiti,0,0,0,0,1,0,0,1
2020-04-08,Taranaki,0,0,0,0,13,1,0,14
2020-04-08,Waikato,0,3,0,3,143,19,0,162
2020-04-08,Wairarapa,0,0,0,0,6,2,0,8
2020-04-08,Waitemata,4,1,0,5,127,48,0,175
2020-04-08,West Coast,0,0,0,0,4,1,1,5
2020-04-08,Whanganui,0,0,0,0,7,0,0,7
2020-04-07,Auckland,1,1,0,2,108,29,0,137
2020-04-07,Bay of Plenty,1,0,0,1,30,8,0,38
2020-04-07,Canterbury,1,3,0,4,75,44,0,119
2020-04-07,Capital and Coast,0,0,0,0,64,17,0,81
2020-04-07,Counties Manukau,1,1,0,2,87,17,0,104
2020-04-07,Hawke's Bay,1,0,0,1,31,4,0,35
2020-04-07,Hutt Valley,0,0,0,0,17,3,0,20
2020-04-07,Lakes,0,0,0,0,12,0,0,12
2020-04-07,Midcentral,0,0,0,0,24,4,0,28
2020-04-07,Nelson Marlborough,0,2,0,2,36,12,0,48
2020-04-07,Northland,2,0,0,2,21,1,0,22
2020-04-07,South Canterbury,0,0,0,0,9,1,0,10
2020-04-07,Southern,7,2,0,9,181,12,0,193
2020-04-07,Tairawhiti,0,0,0,0,1,0,0,1
2020-04-07,Taranaki,0,0,0,0,13,1,0,14
2020-04-07,Waikato,3,2,0,5,143,16,0,159
2020-04-07,Wairarapa,0,0,0,0,6,2,0,8
2020-04-07,Waitemata,7,2,0,9,123,47,0,170
2020-04-07,West Coast,0,0,0,0,4,1,1,5
2020-04-07,Whanganui,0,0,0,0,7,0,0,7
2020-04-06,Auckland,3,3,0,6,107,28,0,135
2020-04-06,Bay of Plenty,2,2,0,4,29,8,0,37
2020-04-06,Canterbury,6,5,0,11,74,41,0,115
2020-04-06,Capital and Coast,1,1,0,2,64,17,0,81
2020-04-06,Counties Manukau,4,3,0,7,86,16,0,102
2020-04-06,Hawke's Bay,1,0,0,1,30,4,0,34
2020-04-06,Hutt Valley,0,0,0,0,17,3,0,20
2020-04-06,Lakes,0,0,0,0,12,0,0,12
2020-04-06,Midcentral,2,0,0,2,24,4,0,28
2020-04-06,Nelson Marlborough,1,1,0,2,36,10,0,46
2020-04-06,Northland,1,0,0,1,19,1,0,20
2020-04-06,South Canterbury,0,0,0,0,9,1,0,10
2020-04-06,Southern,8,0,0,8,174,10,0,184
2020-04-06,Tairawhiti,0,0,0,0,1,0,0,1
2020-04-06,Taranaki,0,0,0,0,13,1,0,14
2020-04-06,Waikato,2,5,0,7,140,14,0,154
2020-04-06,Wairarapa,0,0,0,0,6,2,0,8
2020-04-06,Waitemata,0,2,0,2,116,45,0,161
2020-04-06,West Coast,0,0,0,0,4,1,1,5
2020-04-06,Whanganui,0,0,0,0,7,0,0,7
2020-04-05,Auckland,4,5,0,9,104,25,0,129
2020-04-05,Bay of Plenty,1,0,0,1,27,6,0,33
2020-04-05,Canterbury,1,3,0,4,68,36,0,104
2020-04-05,Capital and Coast,0,0,0,0,63,16,0,79
2020-04-05,Counties Manukau,7,3,0,10,82,13,0,95
2020-04-05,Hawke's Bay,3,1,0,4,29,4,0,33
2020-04-05,Hutt Valley,0,1,0,1,17,3,0,20
2020-04-05,Lakes,0,0,0,0,12,0,0,12
2020-04-05,Midcentral,2,1,0,3,22,4,0,26
2020-04-05,Nelson Marlborough,2,3,0,5,35,9,0,44
2020-04-05,Northland,2,0,0,2,18,1,0,19
2020-04-05,South Canterbury,0,0,0,0,9,1,0,10
2020-04-05,Southern,14,3,0,17,166,10,0,176
2020-04-05,Tairawhiti,0,0,0,0,1,0,0,1
2020-04-05,Taranaki,0,0,0,0,13,1,0,14
2020-04-05,Waikato,3,1,0,4,138,9,0,147
2020-04-05,Wairarapa,0,0,0,0,6,2,0,8
2020-04-05,Waitemata,5,4,0,9,116,43,0,159
2020-04-05,West Coast,0,1,0,1,4,1,1,5
2020-04-05,Whanganui,0,0,0,0,7,0,0,7
2020-04-04,Auckland,5,4,0,9,100,20,0,120
2020-04-04,Bay of Plenty,0,0,0,0,26,6,0,32
2020-04-04,Canterbury,11,6,0,17,67,33,0,100
2020-04-04,Capital and Coast,3,3,0,6,63,16,0,79
2020-04-04,Counties Manukau,3,1,0,4,75,10,0,85
2020-04-04,Hawke's Bay,0,0,0,0,26,3,0,29
2020-04-04,Hutt Valley,0,0,0,0,17,2,0,19
2020-04-04,Lakes,1,0,0,1,12,0,0,12
2020-04-04,Midcentral,2,1,0,3,20,3,0,23
2020-04-04,Nelson Marlborough,3,2,0,5,33,6,0,39
2020-04-04,Northland,1,0,0,1,16,1,0,17
2020-04-04,South Canterbury,0,0,0,0,9,1,0,10
2020-04-04,Southern,9,1,0,10,152,7,0,159
2020-04-04,Tairawhiti,0,0,0,0,1,0,0,1
2020-04-04,Taranaki,0,0,0,0,13,1,0,14
2020-04-04,Waikato,4,2,0,6,135,8,0,143
2020-04-04,Wairarapa,0,0,0,0,6,2,0,8
2020-04-04,Waitemata,5,10,0,15,111,39,0,150
2020-04-04,West Coast,0,0,0,0,4,0,1,4
2020-04-04,Whanganui,0,0,0,0,7,0,0,7
2020-04-03,Auckland,1,2,0,3,95,16,0,111
2020-04-03,Bay of Plenty,0,1,0,1,26,6,0,32
2020-04-03,Canterbury,5,6,0,11,56,27,0,83
2020-04-03,Capital and Coast,3,3,0,6,60,13,0,73
2020-04-03,Counties Manukau,7,1,0,8,72,9,0,81
2020-04-03,Hawke's Bay,5,0,0,5,26,3,0,29
2020-04-03,Hutt Valley,0,1,0,1,17,2,0,19
2020-04-03,Lakes,0,0,0,0,11,0,0,11
2020-04-03,Midcentral,0,0,0,0,18,2,0,20
2020-04-03,Nelson Marlborough,1,1,0,2,30,4,0,34
2020-04-03,Northland,2,0,0,2,15,1,0,16
2020-04-03,South Canterbury,0,0,0,0,9,1,0,10
2020-04-03,Southern,14,1,0,15,143,6,0,149
2020-04-03,Tairawhiti,0,0,0,0,1,0,0,1
2020-04-03,Taranaki,0,0,0,0,13,1,0,14
2020-04-03,Waikato,11,2,0,13,131,6,0,137
2020-04-03,Wairarapa,0,0,0,0,6,2,0,8
2020-04-03,Waitemata,6,2,0,8,106,29,0,135
2020-04-03,West Coast,0,0,0,0,4,0,1,4
2020-04-03,Whanganui,0,0,0,0,7,0,0,7
2020-04-02,Auckland,3,0,0,3,94,14,0,108
2020-04-02,Bay of Plenty,3,1,0,4,26,5,0,31
2020-04-02,Canterbury,4,5,0,9,51,21,0,72
2020-04-02,Capital and Coast,2,2,0,4,57,10,0,67
2020-04-02,Counties Manukau,5,1,0,6,65,8,0,73
2020-04-02,Hawke's Bay,2,3,0,5,21,3,0,24
2020-04-02,Hutt Valley,4,0,0,4,17,1,0,18
2020-04-02,Lakes,0,0,0,0,11,0,0,11
2020-04-02,Midcentral,1,0,0,1,18,2,0,20
2020-04-02,Nelson Marlborough,3,0,0,3,29,3,0,32
2020-04-02,Northland,1,0,0,1,13,1,0,14
2020-04-02,South Canterbury,0,0,0,0,9,1,0,10
2020-04-02,Southern,17,1,0,18,129,5,0,134
2020-04-02,Tairawhiti,0,0,0,0,1,0,0,1
2020-04-02,Taranaki,0,0,0,0,13,1,0,14
2020-04-02,Waikato,7,1,0,8,120,4,0,124
2020-04-02,Wairarapa,0,2,0,2,6,2,0,8
2020-04-02,Waitemata,5,7,0,12,100,27,0,127
2020-04-02,West Coast,0,0,0,0,4,0,1,4
2020-04-02,Whanganui,2,0,0,2,7,0,0,7
2020-04-01,Auckland,3,1,0,4,91,14,0,105
2020-04-01,Bay of Plenty,6,0,0,6,23,4,0,27
2020-04-01,Canterbury,0,2,0,2,47,16,0,63
2020-04-01,Capital and Coast,1,2,0,3,55,8,0,63
2020-04-01,Counties Manukau,5,0,0,5,60,7,0,67
2020-04-01,Hawke's Bay,4,0,0,4,19,0,0,19
2020-04-01,Hutt Valley,0,0,0,0,13,1,0,14
2020-04-01,Lakes,0,0,0,0,11,0,0,11
2020-04-01,Midcentral,1,0,0,1,17,2,0,19
2020-04-01,Nelson Marlborough,3,1,0,4,26,3,0,29
2020-04-01,Northland,1,0,0,1,12,1,0,13
2020-04-01,South Canterbury,0,0,0,0,9,1,0,10
2020-04-01,Southern,15,1,0,16,112,4,0,116
2020-04-01,Tairawhiti,0,0,0,0,1,0,0,1
2020-04-01,Taranaki,1,0,0,1,13,1,0,14
2020-04-01,Waikato,8,1,0,9,113,3,0,116
2020-04-01,Wairarapa,0,0,0,0,6,0,0,6
2020-04-01,Waitemata,9,5,0,14,95,20,0,115
2020-04-01,West Coast,1,0,0,1,4,0,1,4
2020-04-01,Whanganui,2,0,0,2,5,0,0,5
2020-03-31,Auckland,4,4,0,8,88,13,0,101
2020-03-31,Bay of Plenty,2,1,0,3,17,4,0,21
2020-03-31,Canterbury,2,1,0,3,47,14,0,61
2020-03-31,Capital and Coast,2,0,0,2,54,6,0,60
2020-03-31,Counties Manukau,5,2,0,7,55,7,0,62
2020-03-31,Hawke's Bay,0,0,0,0,15,0,0,15
2020-03-31,Hutt Valley,1,0,0,1,13,1,0,14
2020-03-31,Lakes,0,0,0,0,11,0,0,11
2020-03-31,Midcentral,4,0,0,4,16,2,0,18
2020-03-31,Nelson Marlborough,2,0,0,2,23,2,0,25
2020-03-31,Northland,1,0,0,1,11,1,0,12
2020-03-31,South Canterbury,0,0,0,0,9,1,0,10
2020-03-31,Southern,7,2,0,9,97,3,0,100
2020-03-31,Tairawhiti,0,0,0,0,1,0,0,1
2020-03-31,Taranaki,0,0,0,0,12,1,0,13
2020-03-31,Waikato,24,0,0,24,105,2,0,107
2020-03-31,Wairarapa,1,0,0,1,6,0,0,6
2020-03-31,Waitemata,9,3,0,12,86,15,0,101
2020-03-31,West Coast,0,0,0,0,3,0,1,3
2020-03-31,Whanganui,0,0,0,0,3,0,0,3
2020-03-30,Auckland,2,1,0,3,84,9,0,93
2020-03-30,Bay of Plenty,4,0,0,4,15,3,0,18
2020-03-30,Canterbury,1,0,0,1,45,13,0,58
2020-03-30,Capital and Coast,0,1,0,1,52,6,0,58
2020-03-30,Counties Manukau,7,2,0,9,50,5,0,55
2020-03-30,Hawke's Bay,3,0,0,3,15,0,0,15
2020-03-30,Hutt Valley,0,0,0,0,12,1,0,13
2020-03-30,Lakes,2,0,0,2,11,0,0,11
2020-03-30,Midcentral,1,0,0,1,12,2,0,14
2020-03-30,Nelson Marlborough,1,1,0,2,21,2,0,23
2020-03-30,Northland,1,0,0,1,10,1,0,11
2020-03-30,South Canterbury,1,0,0,1,9,1,0,10
2020-03-30,Southern,9,0,0,9,90,1,0,91
2020-03-30,Tairawhiti,0,0,0,0,1,0,0,1
2020-03-30,Taranaki,1,0,0,1,12,1,0,13
2020-03-30,Waikato,5,0,0,5,81,2,0,83
2020-03-30,Wairarapa,0,0,0,0,5,0,0,5
2020-03-30,Waitemata,6,3,0,9,77,12,0,89
2020-03-30,West Coast,0,0,0,0,3,0,1,3
2020-03-30,Whanganui,0,0,0,0,3,0,0,3
2020-03-29,Auckland,8,1,0,9,82,8,0,90
2020-03-29,Bay of Plenty,0,0,0,0,11,3,0,14
2020-03-29,Canterbury,1,1,0,2,44,13,0,57
2020-03-29,Capital and Coast,7,1,0,8,52,5,0,57
2020-03-29,Counties Manukau,4,0,0,4,43,3,0,46
2020-03-29,Hawke's Bay,0,0,0,0,12,0,0,12
2020-03-29,Hutt Valley,0,0,0,0,12,1,0,13
2020-03-29,Lakes,0,0,0,0,9,0,0,9
2020-03-29,Midcentral,1,1,0,2,11,2,0,13
2020-03-29,Nelson Marlborough,1,0,0,1,20,1,0,21
2020-03-29,Northland,2,0,0,2,9,1,0,10
2020-03-29,South Canterbury,1,1,0,2,8,1,0,9
2020-03-29,Southern,12,0,0,12,81,1,0,82
2020-03-29,Tairawhiti,0,0,0,0,1,0,0,1
2020-03-29,Taranaki,0,0,0,0,11,1,0,12
2020-03-29,Waikato,16,0,0,16,76,2,0,78
2020-03-29,Wairarapa,0,0,0,0,5,0,0,5
2020-03-29,Waitemata,14,2,0,16,71,9,0,80
2020-03-29,West Coast,0,0,1,0,3,0,1,3
2020-03-29,Whanganui,0,0,0,0,3,0,0,3
2020-03-28,Auckland,13,2,0,15,74,7,0,81
2020-03-28,Bay of Plenty,2,0,0,2,11,3,0,14
2020-03-28,Canterbury,5,4,0,9,43,12,0,55
2020-03-28,Capital and Coast,5,0,0,5,45,4,0,49
2020-03-28,Counties Manukau,6,1,0,7,39,3,0,42
2020-03-28,Hawke's Bay,1,0,0,1,12,0,0,12
2020-03-28,Hutt Valley,0,0,0,0,12,1,0,13
2020-03-28,Lakes,1,0,0,1,9,0,0,9
2020-03-28,Midcentral,1,0,0,1,10,1,0,11
2020-03-28,Nelson Marlborough,1,0,0,1,19,1,0,20
2020-03-28,Northland,0,0,0,0,7,1,0,8
2020-03-28,South Canterbury,1,0,0,1,7,0,0,7
2020-03-28,Southern,13,0,0,13,69,1,0,70
2020-03-28,Tairawhiti,0,0,0,0,1,0,0,1
2020-03-28,Taranaki,0,0,0,0,11,1,0,12
2020-03-28,Waikato,3,0,0,3,60,2,0,62
2020-03-28,Wairarapa,0,0,0,0,5,0,0,5
2020-03-28,Waitemata,13,0,0,13,57,7,0,64
2020-03-28,West Coast,0,0,0,0,3,0,0,3
2020-03-28,Whanganui,0,0,0,0,3,0,0,3
2020-03-27,Auckland,6,1,0,7,61,5,0,66
2020-03-27,Bay of Plenty,3,0,0,3,9,3,0,12
2020-03-27,Canterbury,2,2,0,4,38,8,0,46
2020-03-27,Capital and Coast,3,0,0,3,40,4,0,44
2020-03-27,Counties Manukau,5,1,0,6,33,2,0,35
2020-03-27,Hawke's Bay,1,0,0,1,11,0,0,11
2020-03-27,Hutt Valley,3,0,0,3,12,1,0,13
2020-03-27,Lakes,0,0,0,0,8,0,0,8
2020-03-27,Midcentral,2,0,0,2,9,1,0,10
2020-03-27,Nelson Marlborough,0,0,0,0,18,1,0,19
2020-03-27,Northland,0,0,0,0,7,1,0,8
2020-03-27,South Canterbury,4,0,0,4,6,0,0,6
2020-03-27,Southern,19,0,0,19,56,1,0,57
2020-03-27,Tairawhiti,0,0,0,0,1,0,0,1
2020-03-27,Taranaki,5,0,0,5,11,1,0,12
2020-03-27,Waikato,11,0,0,11,57,2,0,59
2020-03-27,Wairarapa,0,0,0,0,5,0,0,5
2020-03-27,Waitemata,2,2,0,4,44,7,0,51
2020-03-27,West Coast,0,0,0,0,3,0,0,3
2020-03-27,Whanganui,3,0,0,3,3,0,0,3
2020-03-26,Auckland,11,1,0,12,55,4,0,59
2020-03-26,Bay of Plenty,2,1,0,3,6,3,0,9
2020-03-26,Canterbury,12,2,0,14,36,6,0,42
2020-03-26,Capital and Coast,2,1,0,3,37,4,0,41
2020-03-26,Counties Manukau,3,0,0,3,28,1,0,29
2020-03-26,Hawke's Bay,4,0,0,4,10,0,0,10
2020-03-26,Hutt Valley,4,0,0,4,9,1,0,10
2020-03-26,Lakes,1,0,0,1,8,0,0,8
2020-03-26,Midcentral,0,0,0,0,7,1,0,8
2020-03-26,Nelson Marlborough,0,0,0,0,18,1,0,19
2020-03-26,Northland,1,1,0,2,7,1,0,8
2020-03-26,South Canterbury,0,0,0,0,2,0,0,2
2020-03-26,Southern,7,0,0,7,37,1,0,38
2020-03-26,Tairawhiti,1,0,0,1,1,0,0,1
2020-03-26,Taranaki,1,1,0,2,6,1,0,7
2020-03-26,Waikato,10,0,0,10,46,2,0,48
2020-03-26,Wairarapa,0,0,0,0,5,0,0,5
2020-03-26,Waitemata,8,3,0,11,42,5,0,47
2020-03-26,West Coast,2,0,0,2,3,0,0,3
2020-03-26,Whanganui,0,0,0,0,0,0,0,0
2020-03-25,Auckland,11,0,0,11,44,3,0,47
2020-03-25,Bay of Plenty,2,0,0,2,4,2,0,6
2020-03-25,Canterbury,4,1,0,5,24,4,0,28
2020-03-25,Capital and Coast,4,0,0,4,35,3,0,38
2020-03-25,Counties Manukau,5,0,0,5,25,1,0,26
2020-03-25,Hawke's Bay,3,0,0,3,6,0,0,6
2020-03-25,Hutt Valley,1,0,0,1,5,1,0,6
2020-03-25,Lakes,3,0,0,3,7,0,0,7
2020-03-25,Midcentral,1,1,0,2,7,1,0,8
2020-03-25,Nelson Marlborough,4,0,0,4,18,1,0,19
2020-03-25,Northland,2,0,0,2,6,0,0,6
2020-03-25,South Canterbury,0,0,0,0,2,0,0,2
2020-03-25,Southern,9,0,0,9,30,1,0,31
2020-03-25,Tairawhiti,0,0,0,0,0,0,0,0
2020-03-25,Taranaki,1,0,0,1,5,0,0,5
2020-03-25,Waikato,20,1,0,21,36,2,0,38
2020-03-25,Wairarapa,0,0,0,0,5,0,0,5
2020-03-25,Waitemata,10,1,0,11,34,2,0,36
2020-03-25,West Coast,0,0,0,0,1,0,0,1
2020-03-25,Whanganui,0,0,0,0,0,0,0,0
2020-03-24,Auckland,7,0,0,7,33,3,0,36
2020-03-24,Bay of Plenty,1,2,0,3,2,2,0,4
2020-03-24,Canterbury,7,0,0,7,20,3,0,23
2020-03-24,Capital and Coast,10,0,0,10,31,3,0,34
2020-03-24,Counties Manukau,2,0,0,2,20,1,0,21
2020-03-24,Hawke's Bay,2,0,0,2,3,0,0,3
2020-03-24,Hutt Valley,0,0,0,0,4,1,0,5
2020-03-24,Lakes,1,0,0,1,4,0,0,4
2020-03-24,Midcentral,1,0,0,1,6,0,0,6
2020-03-24,Nelson Marlborough,3,1,0,4,14,1,0,15
2020-03-24,Northland,2,0,0,2,4,0,0,4
2020-03-24,South Canterbury,0,0,0,0,2,0,0,2
2020-03-24,Southern,7,0,0,7,21,1,0,22
2020-03-24,Tairawhiti,0,0,0,0,0,0,0,0
2020-03-24,Taranaki,0,0,0,0,4,0,0,4
2020-03-24,Waikato,2,0,0,2,16,1,0,17
2020-03-24,Wairarapa,2,0,0,2,5,0,0,5
2020-03-24,Waitemata,8,0,0,8,24,1,0,25
2020-03-24,West Coast,0,0,0,0,1,0,0,1
2020-03-24,Whanganui,0,0,0,0,0,0,0,0
2020-03-23,Auckland,7,0,0,7,26,3,0,29
2020-03-23,Bay of Plenty,0,0,0,0,1,0,0,1
2020-03-23,Canterbury,4,2,0,6,13,3,0,16
2020-03-23,Capital and Coast,8,1,0,9,21,3,0,24
2020-03-23,Counties Manukau,1,0,0,1,18,1,0,19
2020-03-23,Hawke's Bay,0,0,0,0,1,0,0,1
2020-03-23,Hutt Valley,1,1,0,2,4,1,0,5
2020-03-23,Lakes,1,0,0,1,3,0,0,3
2020-03-23,Midcentral,1,0,0,1,5,0,0,5
2020-03-23,Nelson Marlborough,2,0,0,2,11,0,0,11
2020-03-23,Northland,0,0,0,0,2,0,0,2
2020-03-23,South Canterbury,2,0,0,2,2,0,0,2
2020-03-23,Southern,4,0,0,4,14,1,0,15
2020-03-23,Tairawhiti,0,0,0,0,0,0,0,0
2020-03-23,Taranaki,0,0,0,0,4,0,0,4
2020-03-23,Waikato,4,0,0,4,14,1,0,15
2020-03-23,Wairarapa,0,0,0,0,3,0,0,3
2020-03-23,Waitemata,2,0,0,2,16,1,0,17
2020-03-23,West Coast,0,0,0,0,1,0,0,1
2020-03-23,Whanganui,0,0,0,0,0,0,0,0
2020-03-22,Auckland,7,1,0,8,19,3,0,22
2020-03-22,Bay of Plenty,0,0,0,0,1,0,0,1
2020-03-22,Canterbury,2,1,0,3,9,1,0,10
2020-03-22,Capital and Coast,5,2,0,7,13,2,0,15
2020-03-22,Counties Manukau,8,0,0,8,17,1,0,18
2020-03-22,Hawke's Bay,0,0,0,0,1,0,0,1
2020-03-22,Hutt Valley,1,0,0,1,3,0,0,3
2020-03-22,Lakes,0,0,0,0,2,0,0,2
2020-03-22,Midcentral,0,0,0,0,4,0,0,4
2020-03-22,Nelson Marlborough,5,0,0,5,9,0,0,9
2020-03-22,Northland,1,0,0,1,2,0,0,2
2020-03-22,South Canterbury,0,0,0,0,0,0,0,0
2020-03-22,Southern,2,0,0,2,10,1,0,11
2020-03-22,Tairawhiti,0,0,0,0,0,0,0,0
2020-03-22,Taranaki,0,0,0,0,4,0,0,4
2020-03-22,Waikato,2,1,0,3,10,1,0,11
2020-03-22,Wairarapa,0,0,0,0,3,0,0,3
2020-03-22,Waitemata,5,0,0,5,14,1,0,15
2020-03-22,West Coast,1,0,0,1,1,0,0,1
2020-03-22,Whanganui,0,0,0,0,0,0,0,0
2020-03-21,Auckland,4,0,0,4,12,2,0,14
2020-03-21,Bay of Plenty,1,0,0,1,1,0,0,1
2020-03-21,Canterbury,3,0,0,3,7,0,0,7
2020-03-21,Capital and Coast,1,0,0,1,8,0,0,8
2020-03-21,Counties Manukau,4,0,0,4,9,1,0,10
2020-03-21,Hawke's Bay,0,0,0,0,1,0,0,1
2020-03-21,Hutt Valley,0,0,0,0,2,0,0,2
2020-03-21,Lakes,0,0,0,0,2,0,0,2
2020-03-21,Midcentral,1,0,0,1,4,0,0,4
2020-03-21,Nelson Marlborough,2,0,0,2,4,0,0,4
2020-03-21,Northland,0,0,0,0,1,0,0,1
2020-03-21,South Canterbury,0,0,0,0,0,0,0,0
2020-03-21,Southern,0,0,0,0,8,1,0,9
2020-03-21,Tairawhiti,0,0,0,0,0,0,0,0
2020-03-21,Taranaki,2,0,0,2,4,0,0,4
2020-03-21,Waikato,3,0,0,3,8,0,0,8
2020-03-21,Wairarapa,2,0,0,2,3,0,0,3
2020-03-21,Waitemata,1,0,0,1,9,1,0,10
2020-03-21,West Coast,0,0,0,0,0,0,0,0
2020-03-21,Whanganui,0,0,0,0,0,0,0,0
2020-03-20,Auckland,1,0,0,1,8,2,0,10
2020-03-20,Bay of Plenty,0,0,0,0,0,0,0,0
2020-03-20,Canterbury,2,0,0,2,4,0,0,4
2020-03-20,Capital and Coast,0,0,0,0,7,0,0,7
2020-03-20,Counties Manukau,0,0,0,0,5,1,0,6
2020-03-20,Hawke's Bay,0,0,0,0,1,0,0,1
2020-03-20,Hutt Valley,0,0,0,0,2,0,0,2
2020-03-20,Lakes,1,0,0,1,2,0,0,2
2020-03-20,Midcentral,0,0,0,0,3,0,0,3
2020-03-20,Nelson Marlborough,2,0,0,2,2,0,0,2
2020-03-20,Northland,0,0,0,0,1,0,0,1
2020-03-20,South Canterbury,0,0,0,0,0,0,0,0
2020-03-20,Southern,2,0,0,2,8,1,0,9
2020-03-20,Tairawhiti,0,0,0,0,0,0,0,0
2020-03-20,Taranaki,0,0,0,0,2,0,0,2
2020-03-20,Waikato,1,0,0,1,5,0,0,5
2020-03-20,Wairarapa,0,0,0,0,1,0,0,1
2020-03-20,Waitemata,2,0,0,2,8,1,0,9
2020-03-20,West Coast,0,0,0,0,0,0,0,0
2020-03-20,Whanganui,0,0,0,0,0,0,0,0
2020-03-19,Auckland,2,2,0,4,7,2,0,9
2020-03-19,Bay of Plenty,0,0,0,0,0,0,0,0
2020-03-19,Canterbury,0,0,0,0,2,0,0,2
2020-03-19,Capital and Coast,2,0,0,2,7,0,0,7
2020-03-19,Counties Manukau,1,0,0,1,5,1,0,6
2020-03-19,Hawke's Bay,1,0,0,1,1,0,0,1
2020-03-19,Hutt Valley,2,0,0,2,2,0,0,2
2020-03-19,Lakes,0,0,0,0,1,0,0,1
2020-03-19,Midcentral,3,0,0,3,3,0,0,3
2020-03-19,Nelson Marlborough,0,0,0,0,0,0,0,0
2020-03-19,Northland,0,0,0,0,1,0,0,1
2020-03-19,South Canterbury,0,0,0,0,0,0,0,0
2020-03-19,Southern,1,0,0,1,6,1,0,7
2020-03-19,Tairawhiti,0,0,0,0,0,0,0,0
2020-03-19,Taranaki,0,0,0,0,2,0,0,2
2020-03-19,Waikato,2,0,0,2,4,0,0,4
2020-03-19,Wairarapa,1,0,0,1,1,0,0,1
2020-03-19,Waitemata,1,0,0,1,6,1,0,7
2020-03-19,West Coast,0,0,0,0,0,0,0,0
2020-03-19,Whanganui,0,0,0,0,0,0,0,0
2020-03-18,Auckland,1,0,0,1,5,0,0,5
2020-03-18,Bay of Plenty,0,0,0,0,0,0,0,0
2020-03-18,Canterbury,1,0,0,1,2,0,0,2
2020-03-18,Capital and Coast,1,0,0,1,5,0,0,5
2020-03-18,Counties Manukau,0,0,0,0,4,1,0,5
2020-03-18,Hawke's Bay,0,0,0,0,0,0,0,0
2020-03-18,Hutt Valley,0,0,0,0,0,0,0,0
2020-03-18,Lakes,0,0,0,0,1,0,0,1
2020-03-18,Midcentral,0,0,0,0,0,0,0,0
2020-03-18,Nelson Marlborough,0,0,0,0,0,0,0,0
2020-03-18,Northland,0,0,0,0,1,0,0,1
2020-03-18,South Canterbury,0,0,0,0,0,0,0,0
2020-03-18,Southern,2,0,0,2,5,1,0,6
2020-03-18,Tairawhiti,0,0,0,0,0,0,0,0
2020-03-18,Taranaki,0,0,0,0,2,0,0,2
2020-03-18,Waikato,0,0,0,0,2,0,0,2
2020-03-18,Wairarapa,0,0,0,0,0,0,0,0
2020-03-18,Waitemata,0,0,0,0,5,1,0,6
2020-03-18,West Coast,0,0,0,0,0,0,0,0
2020-03-18,Whanganui,0,0,0,0,0,0,0,0
2020-03-17,Auckland,2,0,0,2,4,0,0,4
2020-03-17,Bay of Plenty,0,0,0,0,0,0,0,0
2020-03-17,Canterbury,1,0,0,1,1,0,0,1
2020-03-17,Capital and Coast,1,0,0,1,4,0,0,4
2020-03-17,Counties Manukau,1,0,0,1,4,1,0,5
2020-03-17,Hawke's Bay,0,0,0,0,0,0,0,0
2020-03-17,Hutt Valley,0,0,0,0,0,0,0,0
2020-03-17,Lakes,1,0,0,1,1,0,0,1
2020-03-17,Midcentral,0,0,0,0,0,0,0,0
2020-03-17,Nelson Marlborough,0,0,0,0,0,0,0,0
2020-03-17,Northland,1,0,0,1,1,0,0,1
2020-03-17,South Canterbury,0,0,0,0,0,0,0,0
2020-03-17,Southern,2,1,0,3,3,1,0,4
2020-03-17,Tairawhiti,0,0,0,0,0,0,0,0
2020-03-17,Taranaki,0,0,0,0,2,0,0,2
2020-03-17,Waikato,0,0,0,0,2,0,0,2
2020-03-17,Wairarapa,0,0,0,0,0,0,0,0
2020-03-17,Waitemata,2,0,0,2,5,1,0,6
2020-03-17,West Coast,0,0,0,0,0,0,0,0
2020-03-17,Whanganui,0,0,0,0,0,0,0,0
2020-03-16,Auckland,1,0,0,1,2,0,0,2
2020-03-16,Bay of Plenty,0,0,0,0,0,0,0,0
2020-03-16,Canterbury,0,0,0,0,0,0,0,0
2020-03-16,Capital and Coast,2,0,0,2,3,0,0,3
2020-03-16,Counties Manukau,0,0,0,0,3,1,0,4
2020-03-16,Hawke's Bay,0,0,0,0,0,0,0,0
2020-03-16,Hutt Valley,0,0,0,0,0,0,0,0
2020-03-16,Lakes,0,0,0,0,0,0,0,0
2020-03-16,Midcentral,0,0,0,0,0,0,0,0
2020-03-16,Nelson Marlborough,0,0,0,0,0,0,0,0
2020-03-16,Northland,0,0,0,0,0,0,0,0
2020-03-16,South Canterbury,0,0,0,0,0,0,0,0
2020-03-16,Southern,0,0,0,0,1,0,0,1
2020-03-16,Tairawhiti,0,0,0,0,0,0,0,0
2020-03-16,Taranaki,2,0,0,2,2,0,0,2
2020-03-16,Waikato,2,0,0,2,2,0,0,2
2020-03-16,Wairarapa,0,0,0,0,0,0,0,0
2020-03-16,Waitemata,0,0,0,0,3,1,0,4
2020-03-16,West Coast,0,0,0,0,0,0,0,0
2020-03-16,Whanganui,0,0,0,0,0,0,0,0
2020-03-15,Auckland,0,0,0,0,1,0,0,1
2020-03-15,Bay of Plenty,0,0,0,0,0,0,0,0
2020-03-15,Canterbury,0,0,0,0,0,0,0,0
2020-03-15,Capital and Coast,0,0,0,0,1,0,0,1
2020-03-15,Counties Manukau,0,0,0,0,3,1,0,4
2020-03-15,Hawke's Bay,0,0,0,0,0,0,0,0
2020-03-15,Hutt Valley,0,0,0,0,0,0,0,0
2020-03-15,Lakes,0,0,0,0,0,0,0,0
2020-03-15,Midcentral,0,0,0,0,0,0,0,0
2020-03-15,Nelson Marlborough,0,0,0,0,0,0,0,0
2020-03-15,Northland,0,0,0,0,0,0,0,0
2020-03-15,South Canterbury,0,0,0,0,0,0,0,0
2020-03-15,Southern,0,0,0,0,1,0,0,1
2020-03-15,Tairawhiti,0,0,0,0,0,0,0,0
2020-03-15,Taranaki,0,0,0,0,0,0,0,0
2020-03-15,Waikato,0,0,0,0,0,0,0,0
2020-03-15,Wairarapa,0,0,0,0,0,0,0,0
2020-03-15,Waitemata,1,0,0,1,3,1,0,4
2020-03-15,West Coast,0,0,0,0,0,0,0,0
2020-03-15,Whanganui,0,0,0,0,0,0,0,0
2020-03-14,Auckland,0,0,0,0,1,0,0,1
2020-03-14,Bay of Plenty,0,0,0,0,0,0,0,0
2020-03-14,Canterbury,0,0,0,0,0,0,0,0
2020-03-14,Capital and Coast,1,0,0,1,1,0,0,1
2020-03-14,Counties Manukau,0,0,0,0,3,1,0,4
2020-03-14,Hawke's Bay,0,0,0,0,0,0,0,0
2020-03-14,Hutt Valley,0,0,0,0,0,0,0,0
2020-03-14,Lakes,0,0,0,0,0,0,0,0
2020-03-14,Midcentral,0,0,0,0,0,0,0,0
2020-03-14,Nelson Marlborough,0,0,0,0,0,0,0,0
2020-03-14,Northland,0,0,0,0,0,0,0,0
2020-03-14,South Canterbury,0,0,0,0,0,0,0,0
2020-03-14,Southern,0,0,0,0,1,0,0,1
2020-03-14,Tairawhiti,0,0,0,0,0,0,0,0
2020-03-14,Taranaki,0,0,0,0,0,0,0,0
2020-03-14,Waikato,0,0,0,0,0,0,0,0
2020-03-14,Wairarapa,0,0,0,0,0,0,0,0
2020-03-14,Waitemata,0,0,0,0,2,1,0,3
2020-03-14,West Coast,0,0,0,0,0,0,0,0
2020-03-14,Whanganui,0,0,0,0,0,0,0,0
2020-03-13,Auckland,0,0,0,0,1,0,0,1
2020-03-13,Bay of Plenty,0,0,0,0,0,0,0,0
2020-03-13,Canterbury,0,0,0,0,0,0,0,0
2020-03-13,Capital and Coast,0,0,0,0,0,0,0,0
2020-03-13,Counties Manukau,0,0,0,0,3,1,0,4
2020-03-13,Hawke's Bay,0,0,0,0,0,0,0,0
2020-03-13,Hutt Valley,0,0,0,0,0,0,0,0
2020-03-13,Lakes,0,0,0,0,0,0,0,0
2020-03-13,Midcentral,0,0,0,0,0,0,0,0
2020-03-13,Nelson Marlborough,0,0,0,0,0,0,0,0
2020-03-13,Northland,0,0,0,0,0,0,0,0
2020-03-13,South Canterbury,0,0,0,0,0,0,0,0
2020-03-13,Southern,1,0,0,1,1,0,0,1
2020-03-13,Tairawhiti,0,0,0,0,0,0,0,0
2020-03-13,Taranaki,0,0,0,0,0,0,0,0
2020-03-13,Waikato,0,0,0,0,0,0,0,0
2020-03-13,Wairarapa,0,0,0,0,0,0,0,0
2020-03-13,Waitemata,0,0,0,0,2,1,0,3
2020-03-13,West Coast,0,0,0,0,0,0,0,0
2020-03-13,Whanganui,0,0,0,0,0,0,0,0
2020-03-12,Auckland,0,0,0,0,1,0,0,1
2020-03-12,Bay of Plenty,0,0,0,0,0,0,0,0
2020-03-12,Canterbury,0,0,0,0,0,0,0,0
2020-03-12,Capital and Coast,0,0,0,0,0,0,0,0
2020-03-12,Counties Manukau,1,0,0,1,3,1,0,4
2020-03-12,Hawke's Bay,0,0,0,0,0,0,0,0
2020-03-12,Hutt Valley,0,0,0,0,0,0,0,0
2020-03-12,Lakes,0,0,0,0,0,0,0,0
2020-03-12,Midcentral,0,0,0,0,0,0,0,0
2020-03-12,Nelson Marlborough,0,0,0,0,0,0,0,0
2020-03-12,Northland,0,0,0,0,0,0,0,0
2020-03-12,South Canterbury,0,0,0,0,0,0,0,0
2020-03-12,Southern,0,0,0,0,0,0,0,0
2020-03-12,Tairawhiti,0,0,0,0,0,0,0,0
2020-03-12,Taranaki,0,0,0,0,0,0,0,0
2020-03-12,Waikato,0,0,0,0,0,0,0,0
2020-03-12,Wairarapa,0,0,0,0,0,0,0,0
2020-03-12,Waitemata,0,0,0,0,2,1,0,3
2020-03-12,West Coast,0,0,0,0,0,0,0,0
2020-03-12,Whanganui,0,0,0,0,0,0,0,0
2020-03-11,Auckland,0,0,0,0,1,0,0,1
2020-03-11,Bay of Plenty,0,0,0,0,0,0,0,0
2020-03-11,Canterbury,0,0,0,0,0,0,0,0
2020-03-11,Capital and Coast,0,0,0,0,0,0,0,0
2020-03-11,Counties Manukau,0,0,0,0,2,1,0,3
2020-03-11,Hawke's Bay,0,0,0,0,0,0,0,0
2020-03-11,Hutt Valley,0,0,0,0,0,0,0,0
2020-03-11,Lakes,0,0,0,0,0,0,0,0
2020-03-11,Midcentral,0,0,0,0,0,0,0,0
2020-03-11,Nelson Marlborough,0,0,0,0,0,0,0,0
2020-03-11,Northland,0,0,0,0,0,0,0,0
2020-03-11,South Canterbury,0,0,0,0,0,0,0,0
2020-03-11,Southern,0,0,0,0,0,0,0,0
2020-03-11,Tairawhiti,0,0,0,0,0,0,0,0
2020-03-11,Taranaki,0,0,0,0,0,0,0,0
2020-03-11,Waikato,0,0,0,0,0,0,0,0
2020-03-11,Wairarapa,0,0,0,0,0,0,0,0
2020-03-11,Waitemata,0,0,0,0,2,1,0,3
2020-03-11,West Coast,0,0,0,0,0,0,0,0
2020-03-11,Whanganui,0,0,0,0,0,0,0,0
2020-03-10,Auckland,0,0,0,0,1,0,0,1
2020-03-10,Bay of Plenty,0,0,0,0,0,0,0,0
2020-03-10,Canterbury,0,0,0,0,0,0,0,0
2020-03-10,Capital and Coast,0,0,0,0,0,0,0,0
2020-03-10,Counties Manukau,0,0,0,0,2,1,0,3
2020-03-10,Hawke's Bay,0,0,0,0,0,0,0,0
2020-03-10,Hutt Valley,0,0,0,0,0,0,0,0
2020-03-10,Lakes,0,0,0,0,0,0,0,0
2020-03-10,Midcentral,0,0,0,0,0,0,0,0
2020-03-10,Nelson Marlborough,0,0,0,0,0,0,0,0
2020-03-10,Northland,0,0,0,0,0,0,0,0
2020-03-10,South Canterbury,0,0,0,0,0,0,0,0
2020-03-10,Southern,0,0,0,0,0,0,0,0
2020-03-10,Tairawhiti,0,0,0,0,0,0,0,0
2020-03-10,Taranaki,0,0,0,0,0,0,0,0
2020-03-10,Waikato,0,0,0,0,0,0,0,0
2020-03-10,Wairarapa,0,0,0,0,0,0,0,0
2020-03-10,Waitemata,0,0,0,0,2,1,0,3
2020-03-10,West Coast,0,0,0,0,0,0,0,0
2020-03-10,Whanganui,0,0,0,0,0,0,0,0
2020-03-09,Auckland,0,0,0,0,1,0,0,1
2020-03-09,Bay of Plenty,0,0,0,0,0,0,0,0
2020-03-09,Canterbury,0,0,0,0,0,0,0,0
2020-03-09,Capital and Coast,0,0,0,0,0,0,0,0
2020-03-09,Counties Manukau,0,0,0,0,2,1,0,3
2020-03-09,Hawke's Bay,0,0,0,0,0,0,0,0
2020-03-09,Hutt Valley,0,0,0,0,0,0,0,0
2020-03-09,Lakes,0,0,0,0,0,0,0,0
2020-03-09,Midcentral,0,0,0,0,0,0,0,0
2020-03-09,Nelson Marlborough,0,0,0,0,0,0,0,0
2020-03-09,Northland,0,0,0,0,0,0,0,0
2020-03-09,South Canterbury,0,0,0,0,0,0,0,0
2020-03-09,Southern,0,0,0,0,0,0,0,0
2020-03-09,Tairawhiti,0,0,0,0,0,0,0,0
2020-03-09,Taranaki,0,0,0,0,0,0,0,0
2020-03-09,Waikato,0,0,0,0,0,0,0,0
2020-03-09,Wairarapa,0,0,0,0,0,0,0,0
2020-03-09,Waitemata,0,0,0,0,2,1,0,3
2020-03-09,West Coast,0,0,0,0,0,0,0,0
2020-03-09,Whanganui,0,0,0,0,0,0,0,0
2020-03-08,Auckland,0,0,0,0,1,0,0,1
2020-03-08,Bay of Plenty,0,0,0,0,0,0,0,0
2020-03-08,Canterbury,0,0,0,0,0,0,0,0
2020-03-08,Capital and Coast,0,0,0,0,0,0,0,0
2020-03-08,Counties Manukau,0,0,0,0,2,1,0,3
2020-03-08,Hawke's Bay,0,0,0,0,0,0,0,0
2020-03-08,Hutt Valley,0,0,0,0,0,0,0,0
2020-03-08,Lakes,0,0,0,0,0,0,0,0
2020-03-08,Midcentral,0,0,0,0,0,0,0,0
2020-03-08,Nelson Marlborough,0,0,0,0,0,0,0,0
2020-03-08,Northland,0,0,0,0,0,0,0,0
2020-03-08,South Canterbury,0,0,0,0,0,0,0,0
2020-03-08,Southern,0,0,0,0,0,0,0,0
2020-03-08,Tairawhiti,0,0,0,0,0,0,0,0
2020-03-08,Taranaki,0,0,0,0,0,0,0,0
2020-03-08,Waikato,0,0,0,0,0,0,0,0
2020-03-08,Wairarapa,0,0,0,0,0,0,0,0
2020-03-08,Waitemata,0,0,0,0,2,1,0,3
2020-03-08,West Coast,0,0,0,0,0,0,0,0
2020-03-08,Whanganui,0,0,0,0,0,0,0,0
2020-03-07,Auckland,0,0,0,0,1,0,0,1
2020-03-07,Bay of Plenty,0,0,0,0,0,0,0,0
2020-03-07,Canterbury,0,0,0,0,0,0,0,0
2020-03-07,Capital and Coast,0,0,0,0,0,0,0,0
2020-03-07,Counties Manukau,0,0,0,0,2,1,0,3
2020-03-07,Hawke's Bay,0,0,0,0,0,0,0,0
2020-03-07,Hutt Valley,0,0,0,0,0,0,0,0
2020-03-07,Lakes,0,0,0,0,0,0,0,0
2020-03-07,Midcentral,0,0,0,0,0,0,0,0
2020-03-07,Nelson Marlborough,0,0,0,0,0,0,0,0
2020-03-07,Northland,0,0,0,0,0,0,0,0
2020-03-07,South Canterbury,0,0,0,0,0,0,0,0
2020-03-07,Southern,0,0,0,0,0,0,0,0
2020-03-07,Tairawhiti,0,0,0,0,0,0,0,0
2020-03-07,Taranaki,0,0,0,0,0,0,0,0
2020-03-07,Waikato,0,0,0,0,0,0,0,0
2020-03-07,Wairarapa,0,0,0,0,0,0,0,0
2020-03-07,Waitemata,0,0,0,0,2,1,0,3
2020-03-07,West Coast,0,0,0,0,0,0,0,0
2020-03-07,Whanganui,0,0,0,0,0,0,0,0
2020-03-06,Auckland,0,0,0,0,1,0,0,1
2020-03-06,Bay of Plenty,0,0,0,0,0,0,0,0
2020-03-06,Canterbury,0,0,0,0,0,0,0,0
2020-03-06,Capital and Coast,0,0,0,0,0,0,0,0
2020-03-06,Counties Manukau,1,0,0,1,2,1,0,3
2020-03-06,Hawke's Bay,0,0,0,0,0,0,0,0
2020-03-06,Hutt Valley,0,0,0,0,0,0,0,0
2020-03-06,Lakes,0,0,0,0,0,0,0,0
2020-03-06,Midcentral,0,0,0,0,0,0,0,0
2020-03-06,Nelson Marlborough,0,0,0,0,0,0,0,0
2020-03-06,Northland,0,0,0,0,0,0,0,0
2020-03-06,South Canterbury,0,0,0,0,0,0,0,0
2020-03-06,Southern,0,0,0,0,0,0,0,0
2020-03-06,Tairawhiti,0,0,0,0,0,0,0,0
2020-03-06,Taranaki,0,0,0,0,0,0,0,0
2020-03-06,Waikato,0,0,0,0,0,0,0,0
2020-03-06,Wairarapa,0,0,0,0,0,0,0,0
2020-03-06,Waitemata,0,0,0,0,2,1,0,3
2020-03-06,West Coast,0,0,0,0,0,0,0,0
2020-03-06,Whanganui,0,0,0,0,0,0,0,0
2020-03-05,Auckland,0,0,0,0,1,0,0,1
2020-03-05,Bay of Plenty,0,0,0,0,0,0,0,0
2020-03-05,Canterbury,0,0,0,0,0,0,0,0
2020-03-05,Capital and Coast,0,0,0,0,0,0,0,0
2020-03-05,Counties Manukau,0,1,0,1,1,1,0,2
2020-03-05,Hawke's Bay,0,0,0,0,0,0,0,0
2020-03-05,Hutt Valley,0,0,0,0,0,0,0,0
2020-03-05,Lakes,0,0,0,0,0,0,0,0
2020-03-05,Midcentral,0,0,0,0,0,0,0,0
2020-03-05,Nelson Marlborough,0,0,0,0,0,0,0,0
2020-03-05,Northland,0,0,0,0,0,0,0,0
2020-03-05,South Canterbury,0,0,0,0,0,0,0,0
2020-03-05,Southern,0,0,0,0,0,0,0,0
2020-03-05,Tairawhiti,0,0,0,0,0,0,0,0
2020-03-05,Taranaki,0,0,0,0,0,0,0,0
2020-03-05,Waikato,0,0,0,0,0,0,0,0
2020-03-05,Wairarapa,0,0,0,0,0,0,0,0
2020-03-05,Waitemata,0,1,0,1,2,1,0,3
2020-03-05,West Coast,0,0,0,0,0,0,0,0
2020-03-05,Whanganui,0,0,0,0,0,0,0,0
2020-03-04,Auckland,0,0,0,0,1,0,0,1
2020-03-04,Bay of Plenty,0,0,0,0,0,0,0,0
2020-03-04,Canterbury,0,0,0,0,0,0,0,0
2020-03-04,Capital and Coast,0,0,0,0,0,0,0,0
2020-03-04,Counties Manukau,1,0,0,1,1,0,0,1
2020-03-04,Hawke's Bay,0,0,0,0,0,0,0,0
2020-03-04,Hutt Valley,0,0,0,0,0,0,0,0
2020-03-04,Lakes,0,0,0,0,0,0,0,0
2020-03-04,Midcentral,0,0,0,0,0,0,0,0
2020-03-04,Nelson Marlborough,0,0,0,0,0,0,0,0
2020-03-04,Northland,0,0,0,0,0,0,0,0
2020-03-04,South Canterbury,0,0,0,0,0,0,0,0
2020-03-04,Southern,0,0,0,0,0,0,0,0
2020-03-04,Tairawhiti,0,0,0,0,0,0,0,0
2020-03-04,Taranaki,0,0,0,0,0,0,0,0
2020-03-04,Waikato,0,0,0,0,0,0,0,0
2020-03-04,Wairarapa,0,0,0,0,0,0,0,0
2020-03-04,Waitemata,1,0,0,1,2,0,0,2
2020-03-04,West Coast,0,0,0,0,0,0,0,0
2020-03-04,Whanganui,0,0,0,0,0,0,0,0
2020-03-03,Auckland,0,0,0,0,1,0,0,1
2020-03-03,Bay of Plenty,0,0,0,0,0,0,0,0
2020-03-03,Canterbury,0,0,0,0,0,0,0,0
2020-03-03,Capital and Coast,0,0,0,0,0,0,0,0
2020-03-03,Counties Manukau,0,0,0,0,0,0,0,0
2020-03-03,Hawke's Bay,0,0,0,0,0,0,0,0
2020-03-03,Hutt Valley,0,0,0,0,0,0,0,0
2020-03-03,Lakes,0,0,0,0,0,0,0,0
2020-03-03,Midcentral,0,0,0,0,0,0,0,0
2020-03-03,Nelson Marlborough,0,0,0,0,0,0,0,0
2020-03-03,Northland,0,0,0,0,0,0,0,0
2020-03-03,South Canterbury,0,0,0,0,0,0,0,0
2020-03-03,Southern,0,0,0,0,0,0,0,0
2020-03-03,Tairawhiti,0,0,0,0,0,0,0,0
2020-03-03,Taranaki,0,0,0,0,0,0,0,0
2020-03-03,Waikato,0,0,0,0,0,0,0,0
2020-03-03,Wairarapa,0,0,0,0,0,0,0,0
2020-03-03,Waitemata,0,0,0,0,1,0,0,1
2020-03-03,West Coast,0,0,0,0,0,0,0,0
2020-03-03,Whanganui,0,0,0,0,0,0,0,0
2020-03-02,Auckland,0,0,0,0,1,0,0,1
2020-03-02,Bay of Plenty,0,0,0,0,0,0,0,0
2020-03-02,Canterbury,0,0,0,0,0,0,0,0
2020-03-02,Capital and Coast,0,0,0,0,0,0,0,0
2020-03-02,Counties Manukau,0,0,0,0,0,0,0,0
2020-03-02,Hawke's Bay,0,0,0,0,0,0,0,0
2020-03-02,Hutt Valley,0,0,0,0,0,0,0,0
2020-03-02,Lakes,0,0,0,0,0,0,0,0
2020-03-02,Midcentral,0,0,0,0,0,0,0,0
2020-03-02,Nelson Marlborough,0,0,0,0,0,0,0,0
2020-03-02,Northland,0,0,0,0,0,0,0,0
2020-03-02,South Canterbury,0,0,0,0,0,0,0,0
2020-03-02,Southern,0,0,0,0,0,0,0,0
2020-03-02,Tairawhiti,0,0,0,0,0,0,0,0
2020-03-02,Taranaki,0,0,0,0,0,0,0,0
2020-03-02,Waikato,0,0,0,0,0,0,0,0
2020-03-02,Wairarapa,0,0,0,0,0,0,0,0
2020-03-02,Waitemata,1,0,0,1,1,0,0,1
2020-03-02,West Coast,0,0,0,0,0,0,0,0
2020-03-02,Whanganui,0,0,0,0,0,0,0,0
2020-03-01,Auckland,0,0,0,0,1,0,0,1
2020-03-01,Bay of Plenty,0,0,0,0,0,0,0,0
2020-03-01,Canterbury,0,0,0,0,0,0,0,0
2020-03-01,Capital and Coast,0,0,0,0,0,0,0,0
2020-03-01,Counties Manukau,0,0,0,0,0,0,0,0
2020-03-01,Hawke's Bay,0,0,0,0,0,0,0,0
2020-03-01,Hutt Valley,0,0,0,0,0,0,0,0
2020-03-01,Lakes,0,0,0,0,0,0,0,0
2020-03-01,Midcentral,0,0,0,0,0,0,0,0
2020-03-01,Nelson Marlborough,0,0,0,0,0,0,0,0
2020-03-01,Northland,0,0,0,0,0,0,0,0
2020-03-01,South Canterbury,0,0,0,0,0,0,0,0
2020-03-01,Southern,0,0,0,0,0,0,0,0
2020-03-01,Tairawhiti,0,0,0,0,0,0,0,0
2020-03-01,Taranaki,0,0,0,0,0,0,0,0
2020-03-01,Waikato,0,0,0,0,0,0,0,0
2020-03-01,Wairarapa,0,0,0,0,0,0,0,0
2020-03-01,Waitemata,0,0,0,0,0,0,0,0
2020-03-01,West Coast,0,0,0,0,0,0,0,0
2020-03-01,Whanganui,0,0,0,0,0,0,0,0
2020-02-29,Auckland,0,0,0,0,1,0,0,1
2020-02-29,Bay of Plenty,0,0,0,0,0,0,0,0
2020-02-29,Canterbury,0,0,0,0,0,0,0,0
2020-02-29,Capital and Coast,0,0,0,0,0,0,0,0
2020-02-29,Counties Manukau,0,0,0,0,0,0,0,0
2020-02-29,Hawke's Bay,0,0,0,0,0,0,0,0
2020-02-29,Hutt Valley,0,0,0,0,0,0,0,0
2020-02-29,Lakes,0,0,0,0,0,0,0,0
2020-02-29,Midcentral,0,0,0,0,0,0,0,0
2020-02-29,Nelson Marlborough,0,0,0,0,0,0,0,0
2020-02-29,Northland,0,0,0,0,0,0,0,0
2020-02-29,South Canterbury,0,0,0,0,0,0,0,0
2020-02-29,Southern,0,0,0,0,0,0,0,0
2020-02-29,Tairawhiti,0,0,0,0,0,0,0,0
2020-02-29,Taranaki,0,0,0,0,0,0,0,0
2020-02-29,Waikato,0,0,0,0,0,0,0,0
2020-02-29,Wairarapa,0,0,0,0,0,0,0,0
2020-02-29,Waitemata,0,0,0,0,0,0,0,0
2020-02-29,West Coast,0,0,0,0,0,0,0,0
2020-02-29,Whanganui,0,0,0,0,0,0,0,0
2020-02-28,Auckland,0,0,0,0,1,0,0,1
2020-02-28,Bay of Plenty,0,0,0,0,0,0,0,0
2020-02-28,Canterbury,0,0,0,0,0,0,0,0
2020-02-28,Capital and Coast,0,0,0,0,0,0,0,0
2020-02-28,Counties Manukau,0,0,0,0,0,0,0,0
2020-02-28,Hawke's Bay,0,0,0,0,0,0,0,0
2020-02-28,Hutt Valley,0,0,0,0,0,0,0,0
2020-02-28,Lakes,0,0,0,0,0,0,0,0
2020-02-28,Midcentral,0,0,0,0,0,0,0,0
2020-02-28,Nelson Marlborough,0,0,0,0,0,0,0,0
2020-02-28,Northland,0,0,0,0,0,0,0,0
2020-02-28,South Canterbury,0,0,0,0,0,0,0,0
2020-02-28,Southern,0,0,0,0,0,0,0,0
2020-02-28,Tairawhiti,0,0,0,0,0,0,0,0
2020-02-28,Taranaki,0,0,0,0,0,0,0,0
2020-02-28,Waikato,0,0,0,0,0,0,0,0
2020-02-28,Wairarapa,0,0,0,0,0,0,0,0
2020-02-28,Waitemata,0,0,0,0,0,0,0,0
2020-02-28,West Coast,0,0,0,0,0,0,0,0
2020-02-28,Whanganui,0,0,0,0,0,0,0,0
2020-02-27,Auckland,0,0,0,0,1,0,0,1
2020-02-27,Bay of Plenty,0,0,0,0,0,0,0,0
2020-02-27,Canterbury,0,0,0,0,0,0,0,0
2020-02-27,Capital and Coast,0,0,0,0,0,0,0,0
2020-02-27,Counties Manukau,0,0,0,0,0,0,0,0
2020-02-27,Hawke's Bay,0,0,0,0,0,0,0,0
2020-02-27,Hutt Valley,0,0,0,0,0,0,0,0
2020-02-27,Lakes,0,0,0,0,0,0,0,0
2020-02-27,Midcentral,0,0,0,0,0,0,0,0
2020-02-27,Nelson Marlborough,0,0,0,0,0,0,0,0
2020-02-27,Northland,0,0,0,0,0,0,0,0
2020-02-27,South Canterbury,0,0,0,0,0,0,0,0
2020-02-27,Southern,0,0,0,0,0,0,0,0
2020-02-27,Tairawhiti,0,0,0,0,0,0,0,0
2020-02-27,Taranaki,0,0,0,0,0,0,0,0
2020-02-27,Waikato,0,0,0,0,0,0,0,0
2020-02-27,Wairarapa,0,0,0,0,0,0,0,0
2020-02-27,Waitemata,0,0,0,0,0,0,0,0
2020-02-27,West Coast,0,0,0,0,0,0,0,0
2020-02-27,Whanganui,0,0,0,0,0,0,0,0
2020-02-26,Auckland,1,0,0,1,1,0,0,1
2020-02-26,Bay of Plenty,0,0,0,0,0,0,0,0
2020-02-26,Canterbury,0,0,0,0,0,0,0,0
2020-02-26,Capital and Coast,0,0,0,0,0,0,0,0
2020-02-26,Counties Manukau,0,0,0,0,0,0,0,0
2020-02-26,Hawke's Bay,0,0,0,0,0,0,0,0
2020-02-26,Hutt Valley,0,0,0,0,0,0,0,0
2020-02-26,Lakes,0,0,0,0,0,0,0,0
2020-02-26,Midcentral,0,0,0,0,0,0,0,0
2020-02-26,Nelson Marlborough,0,0,0,0,0,0,0,0
2020-02-26,Northland,0,0,0,0,0,0,0,0
2020-02-26,South Canterbury,0,0,0,0,0,0,0,0
2020-02-26,Southern,0,0,0,0,0,0,0,0
2020-02-26,Tairawhiti,0,0,0,0,0,0,0,0
2020-02-26,Taranaki,0,0,0,0,0,0,0,0
2020-02-26,Waikato,0,0,0,0,0,0,0,0
2020-02-26,Wairarapa,0,0,0,0,0,0,0,0
2020-02-26,Waitemata,0,0,0,0,0,0,0,0
2020-02-26,West Coast,0,0,0,0,0,0,0,0
2020-02-26,Whanganui,0,0,0,0,0,0,0,0
